Silpi Köyünde	НАРСПИ
Mart ayı sonlarında	Пуш уйӑхӗн вӗçӗнче
Güneş bakar sıcacık	Хӗвел пӗхрӗ ӑшатса
Çuvaş köyü Silpi’de	Силпи чӑваш ялӗнче
Kar erir çabucacık	Юр ирӗлчӗ васкаса
Kara tepeler  dağlar	Тусем сӑртсем хупхура
Karı eridiğinden	Юрӗ кайса пӗтнӗрен
Yeşerir güçlü otlar	Тухать курӗк çӑn çӑpa
Güneş ısıttığından	Хӗвел хытӑ хӗртнӗрен  
Soğuk  kötü kış biter	Сивӗ хаяр хӗл иртет
Gider üzüle üzüle	Каять йӗрсе хурланса
Soğuk gözyaşı döker	Сивӗ ку ççу лӗпе йӗрет
Üzülür geçen güne	Иртн ӗ кунш ӑн хуйх ӑрса
Irmaklarla  çaylarla	Путӑксемпе варсемпе
Su akıp gürüldüyor	Çӗмӗpӗлce шыв кӗрлет
Ne kadar ağlasa da	Анчах мӗнле йӗрсен те
Gün yaktıkça yakıyor	Хӗвел хӗртнӗçем хӗртет
Kışın gözyaşlarıdır	Хӗл ку ççу лӗ шавласа
Akıp giden ırmakla	Юхса кайрӗ çbipмapa
Sokaklarda  her yerde	Ачи пӑчи выляса
Şimdi çocuklar oynar	Чупса çўрет урамра
Geldi güzel ilkbahar	Килчӗ ырӑ çуркунне
Geldi adı ısıtıp	Килчӗ ячӗ ӑшӑтса
Güneş dünyayı sever	Хӗвел савать тӗнчене
Uykusundan kaldırıp	Хӗл ыйхинчен вӑратса
Kara orman dirilir	Тӗттӗм вӑрман чӗрӗлет
Yeşilleri giyinir	Ешӗл тумтир тӑхӑнать
Bozkır bile yeşerir	Çeçeнxnp те ешерет
Görkemiyle övünür	Илемӗпе мухтанать
Türlü türlü çiçekler	Тӗрлӗ тӗрлӗ чечексен
Güzel kokular saçar	Ырӑ шӗрши сарӗлать
Her yanda türlü kuşlar	Пур çӗрте те кайӑксен
Güzel şarkılar söyler	Лайӑх юрри янӑрать
Bulutların altında	Çyлтe пӗлӗт айӗнче
Tarla kuşları öter	Тӑри юрри илтӗнет
Yumuşacık çimlerde	Çeмçe курӑк çийӗнче
Koyun  kuzu oynaşır	Путек cypӑx сиккелет
Sürüsünün başında	Хӑй кӗтӗвӗ патӗнче
Bir çocuk kaval çalar	Ача шӗхличӗ калать
Karnı çok acıkmış ki	Хырӑмӗ пит выçнипе
Silpi’ye doğru bakar	Силпи ялнелле пӑхать
Silpi köyü  zengin köy	Силпи ялӗ пуян ял
İçinde bir ormanın	Ларать вӑрман ӑшӗнче
Evler kır evi gibi	Кантур пекех çурчӗсем
Altında söğütlerin	Ват йӗмрасем айӗнче
Köyü çevreleyen çit	Ялӗ тавра укӑлча
Taze söğüt dalından	Çӗнӗ çатан укӑлча
Tarlalarda başaklar	Кив капанлӑ анкарти
Bahçelerde yemişler	Тӗрлӗ çимӗçлӗ пахча
Geniş sokak boyunca	Аслӑ урам тӑрӑшшӗпе
Evler ahşap çatılı	Хӑма витнӗ çурчӗсем
Çitsiz yeşil bahçeler	Урам икӗ айӑккипе
Sokakta karşılıklı	Ем ешӗлех сачӗсем
Evlerin avluları	Çypтceм тавра килкарти
Taş duvarla çevrili	Чул хўме пек çавӑрнӑ
Kapıları sarıdır	Capӑ хапха килсерен
Tepeleri nakışlı	Чӗнтӗрленӗ тӑрӑллӑ
Silpi köyü  büyük köy	Силпи ялӗ аслӑ ял
Uzaktan şehir sanki	Хула тейӗн инçетрен
Burası Çuvaşların	Ахӑр кунти чӑвашсен
Malı mülkü herşeyi	Мулӗ пур тӑр çав вӗсен
Bir ırmak gürüldüyor	Çbıpмa юхать кӗрлесе
Büyük köyün yanında	Аслӗ ялӗн çумӗпе
Güneş nakış işliyor	Хӗвел тӗрӗ тӗрлесе
Oynayıp sularıyla	Вылять унӑн шывӗпе
Berrak suyun içinde	Тӑрӑ шывӑн ӑшӗнче
Mavi bulut kıvrılır	Кӑвак пӗлӗт явӑнать
Koca söğüt eğilir	Ватӑ йӑмра тайӑлса
Yansısına sevinir	Тӗсне пӑхса савӑнать
İşte köprü üstünde	Акӑ кӗпер çийӗнче
Bir ihtiyar oltayla	Старик ларать вӑлтапа
Balıklan kandırır	Йӑпӑрт япӑрт пуллине
Yağlı bir solucanla	Улталасшӑн ӑманпа
Ve çocuklar yukarda	Ав ачасем çўл енче
Suda oynaşıyorlar	Шывра ишсе çўреççӗ
Balık tutan yaşlıyı	Пулӑ тытан ваттине
Nasıl da üzüyorlar	Хирӗçтерме пӗлеççӗ
İşte biri köprüde	Акӑ пӗр çын кӗперпе
Irmağı aşıp gider	Каçса пырать çырмана
Karşıya geçer geçmez	Çӑpмa урлӑ каçрӗ те
Ormana dalıp gider	Кӗрсе кайрӗ вӑрмана
Cennetteyim sanılır	Çӑтмax пекех туйӑнать
Silpi Çuvaş köyünde	Силпи чӑваш ялӗнче
Zaman çabucak geçer	Вӑхӑт иртни сисӗнмест
Böyle mutlu günlerde	Савӑнӑçлa кунсенче
Kuş sesi  insan sesi	Кайӑк юрри çын сасси
Yankılanır her yanda	Ян ян ярать таврана
Mutluluk şarkıları	Çypкyннexи хавас юрӑ
Ulaşır kulaklara	Килсе кӗрет хӑлхана
Sokaklarda insanlar	Урам тӑрӑх çыннисем
Bey gibi geziniyor	Улпут пекех утаççӗ
Evlerinin ardında	Пўрт хыçӗнче шавласа
Çocuklar oynaşıyor	Ачи пӑчисем выляççӗ
Al yanaklı güzeller	Нар пек хитре хӗрӗсем
Kuğu gibi süzülür	Акӑшсем пек утаççӗ
Şıngır şıngır takılar	Чӑнк ӑр чанкӑр тенкисем
Yıldır yıldır görünür	Йӑлтӑртатса пыраççӗ
Yeri sarsan yiğitler	Çӗp çӗмӗрсе каччӑсем
Dans eder kapılarda	Ташлать хапха умӗнче
Yaşamak  ah ne güzel	Пурӑнӑçсем ах аван
Büyük Silpi köyünde	Аслӑ Силпи ялӗнче
Bu aydınlık dünyada	Çaкӑ çута тӗнчере
İnsandan güçlü yoktur	Вӑйли çук та этемрен
Suların ve yerlerin	Шывсем çинче çӗр çинче
Tek efendisi odur	Ху çа пулса вӑл тӑрать
Fakat güçlü insan da	Анчах вӑйлӗ этем те
Kendi nefsine esir	Хӑй тӗнчине пӑхӑнать
Para ve şarap ile	Ук çanала эрехех
Yoldan da çıkabilir	Çыннa ӑсран кӑларать
Büyük kalĭm haftası	Аслӑ калӑм эрнинче
Çuvaş nasıl içmesin	Мӗнле чӑваш ӗçмен ши
Derin mahzen içinde	Тарӑн нўхреп ӑшӗнче
İçki nasıl bitmesin	Мӗн чухлӗ сӑра пӗтмен ши
Yedi de o  içti de	Ӗçнӗ те çaв çинӗ те
Dansetti halka halka	Йӗркипеле сикнӗ те
Bundan başka ne türlü	Унсӑр nyçнe еплелле
Kutlanabilir bayram	Тӑвас тетӗн npaçникe
Gün geçtikçe sokakta	Кун иртнӗçем урамра
Artar sarhoş insanlar	118 ўсӗр çынceм нумайрах
Geceleyin ormana	Kaç пулнӑçем вӑрмана
Çokça gider naralar	Сасӑ кять хытӑрах
Akşama dek içip de	Ӗçе ӗçе каçалла
Sarhoş Çuvaş yorulur	ўсӗр чӑваш ывӑнать
İlkyazın çamuru da	Çypкyннexи пылчӑк та
Yatak gibi görünür	Канма çeмçe туйӑнать
Bey gibi yatar Çuvaş	Выртать чӑваш улпут пек
Nerededir  düşünmez	Шухӑшламасть ӑçтине
Bütün sokak boyunca	Пӗтӗм урам тӑрӑшшӗпе
Türküsü de hiç dinmez	Кӑшкӑрать хӑй юррине
Çokça çalış  çokça ye	Нумай ӗçле нумай çн
Çokça terle  çokça iç	Хытӑ тарла хытӑ ӗç
Şarap dersen Çuvaşa	Эрех тесен ӗç çынни
Reddedemez onu hiç	Нихӑшӗ те тиркемест
Vakti gelir çalışır	Вӑхӑчӗпе ӗçлӗпӗр
Vakti gelir içeriz	Вӑхӑчӗпе ӗçӗпӗр
Evde içkimiz yoksa	Килте ӗçме пулмасан
Komşulara gideriz	Куршӗ патне кӗрӗпӗр
Yoksa içki komşuda	Кўршӗн ӑçмe пулмасан
Ayranla yetiniriz	Уйранне те ӗçӗпӗр
Ayran da olmayınca	Уйранӗ те пулмасан
Tanrımızdan bekleriz	Typӑ парасса кӗтӗпӗр
Kalĭm geçer  kar biter	Калӑм иртет юр пӗтет
İlkyazki ekin erer	Çypxи суха та çитeт
Çuvaş hemen ayılmaz	Чӑваш часах урӑлмасть
Mahmurluğu dağılmaz	Мухмӑр иртсе каяймасть
Haydi sarhoş Çuvaşlar	Ӗнтӗ ўсӗр чӑвашсем
Kalkın artık ayağa	Урӑр çине тӑрӑр ха
Yemyeşil yüce dağlar	Ем ешӗлех çўл тусем
Su çekilmiş ırmakta	Шыв та чакнӑ çырмара
Ey kardeşlerim kalkın	Эй пиччесем тӑрӑр ха
Sağa sola bakının	Урлӑ пирлӗ пӑхӑр ха
Çalışmak gibi var mı	Ака пуçне тўрлетес
Tamir et arabanı	Урапуна тирпейлес
Soğuk su insanların	Сивӗ шывпа çӑвӑнсан
Yüzüne renk getirir	Питне куçне тӗс кӗтӗр
Karnını iyi doyur	Авантарах апатлан
Gücüne güç getirir	Ака тума вӑй кӗтӗр
Şimdi atını koşar	Кулес ӗнтӗ лашана
Tarlaya çıkıp gider	Тухса каяс акана
Tanrım bana sağIık ver	Турӑçӑм сывлӑх пар
Ürünüme bereket	Акнӑ тыррӑма ӑнтар
Sarı Kız	Сарӑ Хӗр
Yeşil çimler içinde	Ешӗл курӑк хушшинче
Sapsarı çiçek büyür	Сап сарӑ чечек ўсет
Büyük Silpi köyünde	Аслӑ Силпи ялӗнче
Narspi adlı kız büyür	Нарспи ятлӑ хӗр усет
Yüzü gözü pek güzel	Пичӗ куçӗ пит хўхӗм
San çiçekler gibi	Хирти сарӑ чечек пек
Kapkara iki gözü	Икӗ куçӗ хуп хура
Kara boncuklar gibi	Икӗ хура шӑрçа пек
Salınıyor ardında	Явӑнаççӗ хыçалта
Saçının örgüleri	Çивӗт вӗçӗ катрисем
Bir edayla yürür de	Утса утса пынӑ чух
Şıngırdar takıları	Шӑнкӑртатать тенкисем
Göz ucuyla bakınca	Куçӗсемпе пӑхнӑ чух
Yürekleri hoplatır	Каччӑн чӗри çӗкленет
Narspi bir de gülünce	Çўxe тути кулнӑ чух
Hangi gençte can kalır	Каччан чунӗ çемçелет
Sarı kır çiçeğine	Хирти capӑ чечеке
Kim sevgiyle bakmaz ki	Ӑшӑ куçпа кам пӑхмӗ
Böyle güzel bir kızı	Ун пек лайӑх хитре хӗре
Gençler nasıl sevmez ki	Мӗнле качча юратмӗ
Güneş kaybolduğunda	Хӗвел анса ларсанах
Yıkanır  temizlenir	Питне çӑвать шӑлӑнать
Oyuna çıktığında	Вӑййа тухма шӗлкеме
Düğmeleri oynaşır	Кӑкӑрӗ çине çакать
Şıngır şıngır örtüsü	Шӑнкӑр шӑнкӑр теветне
Omuzundan savrulur	Хулпуççи урлӑ ярать
Al ipek mendili de	Хӗрлӗ пурçӑн тутӑрне
Kız gibi bağlanmıştır	Хӗрле çавӑрса çыхать
Dans ederkenki sesi	Вӑйӑсенче ун сасси
Kuş cıvıltısı gibi	Кайӑк сасси евӗр лӗ
Yüksek sesle gülünce	Ахӑлтатса кулнӑ чух
Sanki bir erkek sesi	Çиpӗп çЫН ку темелле
Oyun bitinceye dek	Вӑйӑ саланичченех  
Sevinç saçar sesiyle	Савӑнтарать сассипе
Sabah yıldızı doğar	Ирхи çӑлтӑр хӑпарса
Gülümser bir tepede	Йӑл йӑл кулать тўпере
Babasının evinde	Хӑйӑн ашшӗ килӗнче
Narspi mutlu  uyuyor	Нарспи канлӗ çЫвӑрать
Güzel düşler görüp de	Ырӑ тӗлӗксем курса
Düşünde seviniyor	Тӗлӗкре те савӗнать
Sabah kalkıp giyinir	Ирех тӑрать тумланать
Narspi işe girişir	Нарспи ӗçе тытӑнать
Ya ipek ip alıp da	E nypçӑН çип илет те
Türkü söyleyip işler	Юрла юрла тӗрӗ тӑвать
Ya dikişe oturup	Е çӗлеме ларать те
Boncuk boncuk dikiyor	Çӗвви шӑрçа пек пулать
İp kuyruklu çelik it	Сўс хўреллӗ xypçӑ йытӑ
Bir girip  bir çıkıyor	Пӗр кӗрет те пӗр тухать
Ya da bez dokur Narspi	Е пир тӗртме ларать те
Oynatarak mekiği	Вылянтарать ӑсине
Ya da makara tutar	Е хулт ӑрчӑ тытать те
Makaraya ip sarar	Çипнe тирет çӗррине
Seki üstünde kedi	Е сак çинчи кушакӗ
Yalayınca yüzünü	Питне çӑва пуçласан
Hazır öğle yemeği	Апат хатӗр хӑнашӑн
Çabuk eli ayağı	А лли ури çӑмӑлран
Çok güzel geçti hayat	Аван иртрӗ пурӑнӑç
Yaşı doluncaya dek	Хӗрӗн çулӗ туличчен
Yedi elden  yabandan	Ашшӗ килне хӑтана
Görücü gelene dek	Çичӗ ютран киличчен
Babacığı Miheter	Нарспи ашшӗ Михетер
Zengin yaşam sürüyor	Çӗpмe пуян пурӑнать
Çok da sevip kızını	Вӑл хӑй хӗрне юратать
Narspi’yle övünüyor;	Нарспиӗпе мухтанать
Kimde var böyle bir kız	Ман хӗр пекки камӑн пур
Kime kısmet böylesi	Кама пўрнӗ ун пек хӗр
Yok mu ayakkabısı	Пушмак çук и хӗрӗмӗн
Dolaşır mı takısız	Çypeт и вӑл тенкӗсӗр
Silpi köyü ömründe	Силпи ялӗ ӗмӗрне
Böyle bir kız görmemiş	Ун пек хӗрсем курас çук
Bir Çuvaş da kızına	Пӗр чӑваш та хӑй хӗрне
Onun gibi bakmamış	Михетер пек пӑхас çук
Miheter’in neyi yok	Михетере мӗн çитмен
Neyim yok  der  evimde	Мӗнӗм çук ши çуртӑмра
Gümüş para  ipek bez	Кӗмӗл тенкӗ тӗртнӗ пир
Az mı mahzenlerimde	Сахал шим мӗн çупçемре
Аrpа  buğday dopdolu	Тырӑ пулӑ туллиех
Azalır mı mahzende	Ишӗлмест и кӗлетре
Yağ  süt  peynir  içki  bal	Çy сӗт турӑх cӑp a пыл
Dolu durur kilerde	Тулли мар и нўхрепре
Doğru sözün yalanı yok	Чӑн сӑмахӑн суйи çук
Miheter’de ne eksik	Михетер ӗн мӗн çитмест
Köyün bir tek zengini	Пӗтӗм ялта пӗр пуян
Ona erişilir mi	Ӑна никам çитеймест
Evi benzer kaleye	Унӑн çурчӗ хула пек
Girsen uçsuz bucaksız	Кӗрсен витӗр тухма çук
Binanın tepesine	Хуралтисен тӗррине
Kuş uçsa erişemez	Чӑх чӗп вӗçсе çитме çук
Avlu dolu mal ile	Карташ тулли япала
Yığın yığın yatıyor	Купаланса выртаççӗ
Am bar dolu darıyla	Кӗлет тулли тыррисем
Taşmış gibi duruyor	Тӑкӑнас пек тӑраççӗ
Atlar urhamah gibi	Урхамах пек лашисем
Ot ve yulaf yiyorlar	Утӑ сӗлӗ çиеççӗ
Koyun ve kuzuları	Унӑн выльӑх чӗрлӗхсем
Fıçıya benziyorlar	Пичӗке пек çўреççӗ
Köyün üstündeki ev	Тури касри çак кил çурт
Uzaktan da görünür	Аякранах курӑнать
Bizim yaşlı Miheter	Пирӗн ватӑ Михетер
Hakkı ile övünür	Тивӗçлипе мухтанать
İyi insan Miheter	Çaк ырӑ çын Михетер
Çok severek kızını	Хӑйӗн хӗрне юратса
Śĭvarni arkasından	Аслӑ çӑварни хыççӑнах
Ona bir nişan yaptı	Хучӗ ӑна çураçса
Düğünüyse köylüler	Пулас туя ялйышсем
Sabırsızlıkla bekler	Тўсеймесӗр кӗтеççӗ
İki zengin düğünü	Икӗ пуян пӗрлешсен
Güzel de olur derler	Шеп те пулӗ туй    тeççӗ
Bayram ne gün gelecek	Çинçe хӑçан çитӗ ши
Zaman nasıl geçecek	Епле вӑхӑт ирттерес
Śimk günü uzak mı	Çнмӗk кунӗ инçе ши
Nasıl beklenilecek	Епле унчченех tўcec
Miheter’in evinde	Михетерӗн килӗнче
Armağanlar dikilir	Парне валли çӗлеççӗ
Büyük düğün uğruna	Туйан хӑватне сиссе
Tüm ev halkı yorulur	Вӑйран тухса ӗçлеççӗ
Fakat Narspi  sarı kız	Анчах Нарспи capӑ хӗр
Düğüne üzülüyor	Туй пуласран хурланать
Gizli gizli ağlayıp	Вӑрттӑн вӑрттӑн вӑл йӗрет
Setner’i anımsıyor	Сетнер ятне асӑнать
Köyün üst tarafında	Ял вӗçӗнче тукасра
Küçücük bir ev durur	Пӗчӗкçеççӗ пурт ларать
Annesiyle bu evde	Амӑшӗпе çак пўртре
Sevdiği Setner vardır	Сетнер ача пурӑнать
Güzel çocuk Setner’in	Чипер ача Сетнерӗн
Bir urhamah atı var	Пӗр урхамах лаши пур
Yaşlı bir annesiyle	Ватӑ карчӑк амӑш пур
Sıcacık yüreği var	Вӗри юнлӑ чӗри пур
İki güçlü eli var	Икӗ вӑйлӑ алли пур
Düşmanı yok edecek	Тӑшман пуçне пӗтерме
Alev gibi öfkesi	Вӗри вут пек çилли пур
Bundan başka Setner’in	Унтан урӑх Сетнерӗн
Bir şeyi yok dünyada	Нимӗн те çук япала
Ama dikkat Miheter	Анчах асту Михетер
Kızı vermez yoksula	Хӗрне памасть çукалл
Bizim Narspi  sarı kız	Пирӗн Нарспи сарӑ хӗр
Bu Setner’i seviyor	Çaв Сетнере юратать
O nedenle sarı kız	Çaв ӑнпала сарӑ хӗр
Düğüne üzülüyor	Туй пуласран хурланать
Yüksek oluk yanında	Çўлӗ Ьалак патӗнче
Yaşlı söğüt yeşerir	Ватӑ йӑмра ешерет
Sabah erken orada	Куллен ирех çавӑнта
Setner Narspi’yi bekler	Сетнер Нарспие кӗтет
Beklerken de su verir	Кӗте кӗте шӑварать
O urhamah atına	Урхамах пек лашине
Kovalarıyla gelir	Шыва анать витрепе
Narspi her gün yanına	Нарспи куллен ирхине
Narspi iki kovayla	Нарспи икӗ витрипе
Çıngır çıngır gelince	Шӑлтӑр шӑлтӑр килет çкe
Sevincinden Setner’in	Савӑннипе Сетнерӗн
Kalbi çarpar delice	Чӗри кӑлт кӑлт сикет  çкe
Narspi’nin dudakları	Нарспин çўxe тутисем
Uzaktan gülümsüyor	Кулаççӗ çке тaçтanax
Yüksek oluk başında	Çўлӗ валак пуçӗнче
Setner aydınlanıyor	Сетнер тӗрать çутӑлсах
Işıl ışıl gözlerle	Йӑлтӑр  ялтӑр куçӗсем
Kızın yüzüne bakar	Сарӑ хӗр çине пӑхаççӗ
Bıyıklı dudakları	Сар м ӗйӗхл ӗ тутисем
Sıcacık sözler söyler	Ӑшӑ сӑмах калаççӗ
Śimik Akşamı	Çимӗк Каçӗ
Çağıl çağıl su akar	Шӑнкӗртатса шыв юхать
Yüksek oluk başında	Çўлӗ валак пу çӗнче
Gümüş gibi de parlar	Кӗмӗл пекех ялтӑрать
Suyu güneş altında	Шывӗ хӗвел çуттинче
Başında örtüsüyle	Кӗмӗл мерчен тухъяпа
Sarı kız su doldurur	Сарӑ хӗрӗ шыв ӑсать
Sarı genç hem konuşup	Сарӑ каччӑ калаçса
Hem atına su verir	Хӑй лашине шӑварать
Yüksek söğüt üstünde	Çўлӗ йӑмра ӑшӗнче
Kuşlar cıvıldaşıyor	Кайӑк юрлать юррине
At su içip durdukça	Лаши ӗçсе тӑнӑçем
Setner de konuşuyor	Каччи калать сӑмахне
“Artık ben Narspi’çiğim	Çanлах вара Нарспиçӗм
Nasıl mutlu olurum	Çyк шим манӑн ӑрӑскалӑ
Ellere mi veriyor	Çаплах сана ют çӗре
Seni kötü insanlar	Илсе кайӗ шим усал
Ah  mutluluk imkansız	Ах телейӗм çук  тӑр çав
Çok zengin annen baban	Аçу аннў пит пуян
Zengin olduklarından	Хӑйсен пуянлӑхӗпе
Kaçıyorlar yoksuldan	Пӑрӑнаççӗ çук çынран
Setner’im öfkelenme	Ан ўпкелешсем Сетнер
Hiç kimselere kızma	Мӗншӗн çынна ўпкелес
Nasıl kaçabiliriz	Ӑçтa тарса каяс ха
Zenginse anne baba	Пуян атте аннерен
Annem babam akılsız	Атте анне ухмах çав
Nasıl kandıracağız	Мӗн каласа кӑнтарас
Ne yapacağız  söyle	Мӗн тӑвар ха кала ха
Ne çare bulacağız	Мӗнле пирӗн май тупас
Güneş battığı vakit	Хӗвел ансан каç пулсан
Düğünüm başlayacak	Паян туя лартаççӗ
Huşĭlkalı zenginle	Хушӑлкари пуянпа
Düğünüm kurulacak	Манӑн туя пуçлаççӗ
Düşman kötü  diyorlar	Тӑшман ытла хаяр тет
Nasıl kurtulacağız	Епле унтан хӑтӑлас
Setner’im hadi söyle	Сетнер Сетнер кала ха
Böyle ne olacağız	Ӑçтa каяс мӗн тӑвас
Mutluydum sınırsızca	Сана тем пек юратса
Seni sevdim yalnızca	Савса эпӗ пурӑнтӑм
Ne yazık ki genç yaşta	Анчах çапах çак куна
Gördüm işte bugünü	Çамрӑк пуçӑмпа куртӑм
Yapayalnız bir başım	Пӗртен пӗрех пуçӑм пур
Sıcacık yüreğim var	Вӗри юнлӑ чӗрем пур
Yaşlı bir anacığım	Ватӑ карчӑк аннем пур
Bir urhamah atım var	Урхамах пек утӑм пур
Hepsinden de değerli	Вӗсенчен те хаклӑрах
En sevgili sen varsın	Чунӑм савни эсӗ пур
Fakat bugün seni de	Анчах сана та паян
Düşman mı çekip alsın	Туртса илен тӑшман пур
Düşmanı yok edecek	Вӑл тӑшмана пӗтерме
İki güçlü elim var	Икӗ вӑйлӑ аллӑм пур
Onu yok etsem bile	Анчах ӑна пӗтерсен
Ondan kötü dünya var	Унтан усал тӗнче пур
Eğer sen de istersen	Хӑвӑн кӑмӑлу пулсан
Atımıza binelim	Лашам çинe лартӑттам
Uzaklara bu köyden	Аяккаллах ку ялтан
Uçalım da gidelim	Bӗçӗттӗм те кайӑттӑм
Setner  çabuk geri dön	Сетнер таврӑн хӑвӑртрах
Kadın suya iniyor	Шыва анать пӗр арӑм
Seninle konuşurken	Чун савнипе Kaлaçca
Zaman farkedilmiyor	Уйрӑлассӑн туймарӑм
Peki Narspi  sen sağ ol	Сывӑ пул эппин Нарспи
Ben garibi unutma	Ан ман эппин мӗскӗне
Atı şahlandı birden	Лаши сикрӗ ыткӑнчӗ
Uçup gitti evine	Вӗçсе кайрӗ килнелле
Narspi üzülüp ona	Нарспи ӑна хурланса
Bakakaldı ardından	Пӑхса юлчӗ хыçӗнчен
Donup kaldı yerinde	Хускалмарӗ вырӑнтан
Yitinceye dek gözden	Савни куçран кайиччен
Sağ ol Setner  sen sağ ol	Сывӑ пулах сывӑ пул
Unutabilir miyim	Епле сана манӑп ши
Seninle olmayıp da	Санпа пӗрле пулмасан
Hiç ele gider miyim	Епле ютра пулӑп ши
Niye bu yaşlar Narspi	Мӗншӗн Нарспи хуйхӑратӑн
Nişanlın çok mu yaşlı	Каччу ытла ватӑ им
Az mı armağanları	Парнў ытла сахал им
Geldi de kadın dedi	Терӗ арӑм çитрӗ те
Narspi suyu doldurup	Нарспи шывне ӑсрӗ те
Eve doğru yürüdü	Килне утрӗ хуйхӑрса
Setner için üzülüp	Килне çитрӗ йӗрсе ячӗ
Ağlamaya başladı	Сетнерӗшӗн хурланса
Evde yaşlı annesi	Пўртре ватӑ карч ӑкӗ
Boşuna söyleniyor	Вӑрçса çўрет ахалех
Miheter tek başına	Сиплет тулта Михетер
Araba onarıyor	Туй кўмине пӗчченех
Çalışır yaşlı adam	Ӗçлет ватӑ пуçӗпе
Baltayla ağaç keser	Пурттипеле каскалать
Sevgili kızı için	Савна хӗршӗн тӑрӑшса
Akıtır alnından ter	Пичӗ тӑрӑх тар юхать
Küçücükten büyüttüm	Мӗн кӗçӗнрен ўстертӗм
Getirdim bu zamana	ÇaK тарана çитерме
Şimdiyse bana düşen	Ӗнтӗ паян юлашки
Görev budur kızıma	Ӗçӗм пултӗр хӗрӗме
Gelinlik çağı geldi	Усрӗ çитрӗ пулчӗ хӗр
Zengin bir koca gerek	Пуян упӑшка кирлӗ
Bulundu bir nişanlı	Упӑшкине тупрӑмӑр
Araba iyi gerek	Кўми лайӑхрах кирлӗ
Çıkageldi śimik de	Çитрӗ ӗнтӗ çимӗк те
Düğünü yapılmalı	Хӗрӗн туйне тумалла
Eşi dostu toplayıp	Тантӑшӑмсем пухӑнсан
Gece düğün kurmalı	Кӗçӗр туйне лартмалла
Miheter’in evinde	Михетерӗн килӗнче
Döner içki fıçısı	Сӑра пичӗки кусать
Tüm insanların köyde	Ялти тантӑш тӑвансен
Irmak gibi boğazı	Пырӗ тӗпӗ ярӑнать
İki büyük sobada	Икӗ пысӑк кӑмака
Türlü yemekler pişer	Тӗрлӗ апат пӑсланать
Eşin dostun tüm köyde	Ялти тантӑш тӑвансен
Ağzından sular akar	Тута çӑвар çуланать
Kara evde çalgıcı	Хура пўртре шӑпӑрçӑ
Saza düzen veriyor	Ларать шӑпӑр тўрлетсе
Köydeki yiğitlerin	Ялти çамрӑк каччӑсен
Ayakları oynuyor	Ури каять çӗкленсе
Büyük diye bu düğün	Туйӑн хӑватн е кӗтсе
Herkes kanatlanıyor	Пурте вӗçсе çўреççӗ
Yalnız derdini kızın	Килти пӗр чун хуйхине
Hiç kimse anlamıyor	Пӗртте вӗсем сисмеççӗ
Oysa mutfakta Narspi	Нарспи ларать лаççинче
Gözleme yağlayarak	Икерчӗсем çуласа
Nişanlısını anar	Çypaçнипe асӑнса
Zavallı ağlayarak	Ларать мӗскӗн хуйхӑpca
Yedi kat bir yabancı	Çичӗ ютран килчӗ ют
Geldi babam evine	Атте килне хӑтана
Veriyor sarı kızı	Сарӑ хӗре çypaçaтb
Bir yabancı zengine	Çичӗ ютри пуяна
Annem  babam ivmeyin	Атте анне ан васкӑр
Bir yıl daha bekleyin	Тата пӗр çул тӑрӑр ха
Biricik kızınızı	Пӗртен пӗрех хӗрӗре
Bir yıl daha saklayın	Тата пӗр çул усрӑр  ха
Sarhoş anne babası	Атте анне ўсӗрпе
Kızı dinlemediler	Хӗрне итлес темерӗ
Nişanlısı zengin ya	Каччи пуян тенипе
Derdini bilm ediler	Хӗрин чунне пӗлмерӗ
Yaşlı yürek  katıdır	Ватӑ чун та хытнӑ чун
Katılaşmış keçedir	Хытса кайнӑ кӗççе çав
Genç yürek  minik yürek	Çамрӑк чун та пӗчӗк чун
Canı yumuşacıktır	Чунӗ ытла çемçе çав
Kuş yüreği olsa da	Кайӑк чунӗ пулсассӑн
Ağlasa hem gülse de	Йӗрӗччӗ те кулӗччӗ
Kanatları olsa da	Суначӗсем пулсассӑн
Uçuverse de gitse	Вӗçӗччӗ те кайӗччӗ
Gün battı kızararak	Хӗвел анчӗ хӗрелсе
Kara orman ardına	Хура вӑрман хыçнелле
Sürü indi koşarak	Кӗту анчӗ кӗрлесе
Büyük Silpi köyüne	Аслӑ Силпи ялнелле
Orada güzel kızlar	Ав унта хитре хӗрсем
Ardısıra koşuyor	Ӗни хыççӑн чупаççӗ
Delikanlılar ise	Чее маттур каччисем
Artlarında kalmıyor	Вӗсен хыççӑн юлмаççӗ
Bak bir adam koşuyor	Акӑ пӗр этем чупать
İneği böğürüyor	Ула ӗни мӗкӗрет
Domuzunu çağırıp	Сӗмcӗр сысни çухӑрать
Bütün köyü yıkıyor	Пӗтӗм яла çӗмӗрет
Sürünün arkasından	Кӗту xыççӑн урампа
Toz bulutu yükseldi	Хура тусан хӑпарать
Bu bulutun içinden	Акӑ тусан ӑшӗнче
Yaşlı kadın belirdi	Карчӑк аран çeç утать
Tek eliyle çekiyor	Хӑй вӑл хӑрах аллипе
O şarap fıçısını	Йӑтнӑ сӑра чӗресси
Ah  ne zor taşıması	Ах хай хӗн пек çӗклесси
Ah  ne kolay içmesi	Ай хай çӑмӑл ӗçесси
Bizim yaşlı Miheter	Пирӗн ватӑ Михетер
Dostunu davet eder	Тантӑшсене йыхӑрать
Yaşlı karısı ise	Унӑн ватӑ карчӑкки
Fıçısını çekeler	Сӑра йӑтнӑ уттарать
Dostlarını dolaşıp	Тантӑш патне кӗрет те
Açıyor fıçısım	Уçать сӑра чӗресне
Düğüne davet edip	Туя пыма йыхӑрса
Sunuyor şarabını	Ӗçтерет туй сӑрине
İyi dostlar  komşular	Ырӑ тантӑш тӑвансем
Bize saygınız yok mu	Пире хисеп тумӑр ши
Kızı veriyoruz ya	Хӗре качча паратпӑр
Düğüne gelen yok mu	Тури касса утмӑр ши
Tabii ki geleceğiz	Пырӑпӑрах пырӑпӑр
Hiç gelmez olur muyuz	Пымасӑрах юлмӑпӑр
Tanrı nasip ederse	Турӑ пўрсен сывӑ пулсан
Gönlünü kırar mıyız	Кӑмӑлӑра татмӑпӑр
Dolaşır yaşlı kadın	Карчӑк яла ӗретлет
Akşam çökünceye dek	Тӗттӗм те пулса çитет
Sonra da eve dönüp	Карчӑк çўрет килиӗнче
Hazırlıyor yiyecek	Çӑкӑр тӑвар хатӗрлет
İyi dostlar  kardeşler	Ырӑ тантӑш   тӑвансем
Düğün evine gidin	Тури касса уттарар
Bereketli şarabı	Перекетлӗ сӑрана
İçerek düğün edin	Ӗçе ӗçе туй лартар
Dostumuz kız veriyor	Пирӗн тӑван хӗр парать
Bizi davet ediyor	Пире унта йыхӑрать
Sevgili kızı için	Хӑйӗн савнӑ хӗрӗшӗн
Büyük düğün kuruyor	Урӑм çурӑм туй пуçлать
Başlatmadan düğünü	Туйне пуçне пуçличчен
Budur Çuvaş töresi	Авал чӑваш йӑлипе
Hatırla yaşlıları	Ваттисене асӑнса
Dağıt tuzu ekmeği	Тӑкар çӑкӑр тӑварне
Yaşlı anne babalar	Ват аттесем аннесем
Kutsayınız cennette	Ырӑ курӑр çӑтмахра
Tuzumuz ekmeğimiz	Пирӗн çӑкӑр тӑварсем
Bulunsun önünüzde	Пулччӑр сирӗн умӑрта
Sevgili Narspi’mize	Пирӗн савнӑ Нарспие
Sunun iyi bir yaşam	Парӑр ырӑ пурӑнӑç
Mutluluk ve sevinci	Парӑр унӑн телейне
Esirgemeyin ondan	Ырӑлӑхпа савӑнӑç
Yaşlıları andılar	Ваттисене асӑнчӗç
Geleneklere göre	Авалхисен йӗркипе
Düğünü başlatmaya	Унтан туя пуçлама
Girdiler beyaz eve	Кӗчӗç шурӑ кӗлете
Şarap kadehi ile	Курка тулли сӑрипе
Babası öğütlüyor	Ашшӗ амӑш пехиллет
Anne baba önünde	Ашшӗ амӑш умӗнче
Kız üzülüp ağlıyor	Хӗрӗ хурланса йӗрет
Narspi  kızım  kutlu ol	Нарспи хӗрӗм пил сана
Kocanı hiç bırakma	Упӑшкуна ан пӑрах
İyi geçin onunla	Аван пурӑн унпала
Huzurlu ol daima	Тату пулӑр яланах
Dinle onu  uysal ol	Итле ӑна йӑваш пул
Uyma kötü insana	Усал çынпа ан çыхлан
İşini yap  çok çalış	Ӗçне ӗçле ӗçчен пул
Gereksizle uğraşma	Кирлӗ марпа ан хӑтлан
Öğütlüyor babası	Атте анне ўкӗтлет
Kız gözyaşı döküyor	Хӗр куççульне юхтарса
Ve artık çalgı sesi	Шӑпӑр сасси чӑйлатать
Düğünü başlatıyor	Туя ячӗç пуçласа
Horuldayarak Silpi	Силпи ялӗ харлатса
Ölmüş gibi uyuyor	Вилнӗ çын пек çывӑрать
Mutlu görüp dünyayı	Тӗнче лӑпкине курса
Gökte ay seviniyor	Çўлтe уйӑx савӑнать
Yorulmuş oynamaktan	Кӗрсе пӗтнӗ вӑйӑран
Sarı kızlar  yiğitler	Сарӑ хӗрсем каччӑсем
Düğün halkı uykuda	Туй халӑхӗ çывӑрать
Uyuyor evdekiler	Çывӑpaççӗ хуçисем
Nefesler soğuyarak	Ӑшӑ сывлӑш сивӗнет
Ses seda kesiliyor	Сасӑ чӗвӗ илтӗнмест
Dolanıyor bir köpek	Пӗр йытӗ çеç вӗркелет
Üşenmeden esniyor	Çӑвар карма ўркенмест
Kuzeyde horoz ötüp	Автан çурçӗр авӑтать
Uyur durduğu yerde	Ларнӑ çӗрте çывӑрать
Yavaşça artık ay da	Хуллен хуллен уйӑх та
Gizleniyor ormana	Вӑрман хыçне пытанать
Tatlı bir uyku ile	Ырӑ тутлӑ ӑйхӑпа
Çuvaş halkı uyuyor	Чӑваш çынни çыв ӑрать
Bir canın yalnız dertle	Пӗр чунӑн çеç хуйхӑпа
Yüreği eziliyor	Çaв каç чӗри çурӑлать
Düğün	Туй
Gün doğunca Silpi’de	Хӗвел тухнӑ тухманах
Gece sıyrılıverdi	Тӗтӗм кайрӗ ял çинче
Gözünü açar açmaz	Куçне уçнӑ у çманах
Çuvaş banyoya girdi	Чӑваш ларать мунчинче
Śilmik geleneğiyle	Çимӗк кунӗ йӑлипе
Herkes banyo yapıyor	Çынceм мунча кӗреççӗ
Śimik otları ile	Çимӗк курӑкӗпеле
Vücudunu ovuyor	Çaнçypӑмнe хӗртеççӗ
Yaşlı anne babalar	Ват аттесем аннесем
Böyle buyuruverdi	Çaплa хушса хӑварнӑ
Çuvaşlar da banyoya	Çaплa паян чӑвашсем
Girip tertemiz oldu	Мунча кӗрсе тасалнӗ
Yeni kıyafetlerle	Çene кӗпе йӗм пеле
Çıktılar sokaklara	Тухрӗç вӗсем урама
Yavaşça yürüyerek	Тухрӗç вӗсем ерипе
Gidiyorlar düğüne	Утрӗç ирех туй курма
İşte düğün  bu düğün	Акӑ туй та акӑ туй
Bizim düğünler böyle	Пирӗн туйсем çа лалла
Büyük düğünün sesi	Тури касри туй сасси
Yankılanır tüm köyde	Янтӑратать çур яла
Miheter’in ev barkı	Михетерӗн кил çурчӗ
Ta uzaktan görünür	Аякранах курӑнать
Sokak kapılarından	Урам енчи хапхаран
Giren çıkan çok olur	Çын кӗрет те çын тухать
Ev önünde insan çok	Пўрт умӗнче çЫН нумай
Düğün görmeye gelen	Килнӗ вӗсем туй курма
Yaşlılar da az değil	Ваттисем те сахал мар
İçki içmeye gelen	Килнӗ вӗсем сӑра ӗçме
Sallanıp kıvrılarak	Ярӑнтарса явӑнса
Saz sesi oynatıyor	Шӑпӑр кӗвви ташлатать
Ev sahibi istiyor	Ырӑ хуçа хушнипе
Herkes düğün yapıyor	Туй халӗхӗ туй тӑвать
Düğün halkı eğlenip	Туй халӑхӑ туй туса
Yorulur da sevinir	Ывӑнать те савӑнать
Saz sesi kesilince	Шӑпӑр сасси чарӑнсан
Türkülere geçilir	Туй юррийӗ пуçланать
Ne kadar sessizsiniz	Мӗншӗн шӑппӑн ларатӑр
Ne kadar sessizsiniz	Мӗншӗн шӑппӑн ларатӑр
Böyle sessiz durulmaz	Шӑппӑн шӑппӑн лармашкӑн
Kuş yavrusu değiliz	Шӑпчӑк чӗппи мар эпир
Fakat saz durmaksızın	Анчах шӑпӑр хӑлӑхсӑр
Dansetmeye çağırır	Татах ташлама чӗнет
Gümbür gümbür danslarla	Кӗрӗс кӗрӗс ташласа
Döşemeler sallanır	Пўрт урайӗ силленет
Tüm konuklar oturup	Ырӑ хӑнасем тӗпелте
Yiyip içip eğlenir	Ӗçсе çисе савӑнаççӗ
Kızlarla yiğitlere	Хӗрӗпеле каччине
Mutlu yaşam dilenir	Ырӑ кунсем сунаççӗ
Sağ olun siz  var olun	Сывӑ пулччӑр пур пулччӑр
Çoluk çocuklu olun	Ача пӑчаллӑ пулччӑр
İyi  güzel yaşayın	Ырӑ тату пурӑнччӑр
Kötü söz işitmeyin	Усал сӑмах ан илтчӗр
Yiyin  için dostlarım	Ӗçер çиер тӑвансем
Her an birlikte olun	Ӗмӗр пӗрле пурӑнар
Kızla delikanlıya	Хӗрпе качча юратса
Güzel bir düğün yapın	Атьӑр шепрех туй тӑвар
İşte şimdi  bak şimdi	Акӑ ӗнтӗ пӑх ӗнтӗ
Ev sahibi oynuyor	Епле ташлать ват хуçа
Kızın düğün sevinci	Хӗрин туйин савӑнӑçӗ
Yaşlıyı coşturuyor	Çӗклет иккен ват пуçа
Gençler  delikanlılar	Маттур пуса каччисем
Danseder ölesiye	Вӑйран тухса сикеççӗ
Ardı sıra da kızlar	Вӗсен хыççӑн хӗрӗсем
Yetişiyor şiirle	Такмак ӗпе çитеççӗ
İpek saçaklı perde	Пурçӑн çўçеллӗ чаршав
Yukarıdan sarkıyor	Маччаранах сулланать
Perdenin arkasında	Хӗрлӗ чаршав хЫçӗнче
Duvaklı kız duruyor	Пӗркенчӗкпе хӗр ларать
Kız oturmuş ağlıyor	Хӗр ларать те хӗр йӗрет
Duvağı kaldırmıyor	Пӗркенчӗкне çӗклемест
Şarkıların sesinden	Хӗр çуммисем юрласа
Hıçkırık duyulmuyor	Унӑн сасси илтӗнмест
Kızlar şarkılarında	Хӗр çуммисем юрринче
Narspi’yi anıyorlar	Асӑнаççӗ Нарспие
Miheter’in kızına	Михетерӗн Нарспине
Bir düğün yapıyorlar	Тӑваççӗ мӗн ун туйне
Ak sakallı Tĭhtaman	Шурӑ сухал Тӑхтаман
Ona koca olmalı	Упӑшкийӗ пулмалла
Kendi sevgilisinden	Хӑйӗн чунӗ савнинчен
Caymalı da caymalı	Каймаллипех каймалла
Sen ele vardığında	Эсӗ юта кайсассӑн
Ne yapacak Setner’in	Мӗн тӑвӗ ши Сетнерў
Güzel Narspi ablamız	Ырӑ Нарспи аппаçӑм
Hani senin talihin	Ӑçтa санӑн телейў
Düğün gürültüsünün	Туй тӑваççӗ çӗмӗрсе
Sanki biteceği yok	Унӑн — вӗçӗ хӗрри çук
Düğün evine giden	Тантӑш патне çўресе
Köylülerin sonu yok	Ялта тантӑш пӗтес çук
Yüksek deri araba	Çўлӗ сӑран кўмийӗ
Düğüne sürülüyor	Тантӑш патне çўретет
Kızların şarkıları	Хӗр çуммисен юррийӗ
Her yerden duyuluyor	Таçта çитех илтӗнет
Gece gündüz oyun var	Кунӗн çӗрӗн выляма
Çalgı sesi dinmiyor	Шӑпӑрӗ те чарӑнм асть
Devamlı oynamaktan	Кунӗн çӗрӗн ташлама
Gençler de yorulmuyor	Пуса каччи ывӑнмасть
Köyün çoluk çocuğu	Пӗтӗм ялти ача пӑча
Düğün diye koşuyor	Туйӗ хыççӑн хӑвалать
Ölü gibi bir yaşlı	Вилес пекех ватӑ çын
Ev ardında uyuyor	Пўрт хЫç ӗнче çЫвӑрать
Düğünü iyi yapın	Туй тӑвӑр та шеп тӑвӑр
İhtiyarın gücü yok	Ватӑ çыннӑн халӗ çук
Yatmış  yerde zıplıyor	Выртнӑ çӗрте сиккелет
Kalkacak kuvveti yok	Анчах тӑма вӑйӗ çук
Falcıda	Юмӑç Патӗнче
Bir küçücük kara ev	Пӗчӗкçеçӗ хура пўрт
Ak pak adam sekide	Шурӑ старик сак çинче
İşığı koymaz asla	Çутӑ кўртмест нимӗн те
Baca gibi pencere	Тӗнӗ пек çеç чўрече
Yalnızca açık kapı	Уçса хунӑ алӑк çеç
Aydınlatır odayı	Пўртӗн ӑшне çутатать
Bir ışık demetçiği	Хӗвел çутти пайӑрки
Oynatır döşemeyi	Урай тӑрӑх ав шӑвать
İhtiyar baş köşede	Ларать старик тӗпелте
Bir çizme onarıyor	Çӑnaтинe сапласа
Yaşlı eli ayağı	Ват ал ура йӗркипе
Kıpır kıpır oynuyor	Мӗшӗл мӗшӗл маташса
İşte güneş ışığı	Акӑ хӗвел çуттийӗ
Oynayarak geldi de	Шуса шуса пычӗ те
Sıçradı ihtiyarın	Сиксе ларчӗ старикӗн
Ak saçları üstüne	Кӑвак çўçлӗ пуç çине
Śimk sesi sokakta	Çимӗк çуйӗ урамран
Oynatır yüreğini	Çӗклентерет чӗрине
Güneş de dansederek	Хӗвелӗ те выляса
Parlatır saçlarını	Çутатать çўç пӗрчине
Mırıldanıp kendince	Мӑкӑртатса мӑшлатса
Çizmesini yamarken	Çӑпaтинe сапласа
Biri girdi sessizce	Ларнӑ çӗрте сисмен те
Adam farkedemeden	Çын килнине пӗлмен те
Açık kapı önünde	Уçӑ алӑк умӗнче
Yaşlı kadın duruyor	Карчӑк тӑра парать мӗн
Ak saçlı ihtiyara	Кӑвак çўçлӗ старике
Sıcak sözler söylüyor	Ӑшӑ сӑмах калать мӗн
Böyle sıcak konuşan	Ӑшӑ сӑмах калакан
Setner’in annesiydi	Сетнер амӑш пулнӑ мӗн
Onun oğlu Setner’e	Ун ывӑлне Сетнерне
Kötülük ilişmişti	Усал  тӗсел ернӗ мӗн
O nedenle annesi	Çaв ӑнпала амӑшӗṳ
Falcı yanına gitti	Юмӑç патне уттарчӗ
Ağlayıp sızlayarak	Ах ахлатса хуйхӑрса
Dertlerini söyledi	Хӑй хуйхине каларӗ
Çok zaman ihtiyarla	Нумай вӗсем старикпе
Oturup söyleştiler	Ларчӗç сӑмах калаçса
Konuşup sağdan soldan	Калаçнӑ чух хушӑран
Eskileri deştiler	Ӗлӗкхине асӑнса
Birinden hemen sonra	Юлашкинчен тин вара
Sözü aldı beriki	Килӗшрӗ леш старикки
Bir çift çorap  bir gömlek	Мӑшӑр чӑлха пӗр кӗпе
Verecek oldu kadın	Пама пулчӗ карчакки
Sonra ihtiyar kalktı	Вара старик тӗчӗ те
İşini bırakarak	Хӑйӗн ӗçне парахса
Kapattı dış kapıyı	Хупса хучӗ алӑкне
Maşayla dokunarak	Турчӑкипе çаклатса
Üzerine kürk aldı	Çинe кӗрӗк тӑхӑнса
Koltuğuna bir şapka	Çӗлӗк тытрӗ хул айне
Saban üstüne basıp	Ури айне шӑрт хурса
Koydu önüne para	Укçа хучӗ ун умне
Sonra ak sakalını	Унтан шурӑ сухалне
Saçını sıvazlayıp	Кӑвак çўçне якатса
Paraya bir kör gibi	Укçа çине суккӑрскер
Baktı gözünü açıp	Пӑхрӗ куçне чакӑртса
Bakıp durdu  durdu da	Пӑхса тӑчӗ тӑчӗ те
Sakalını okşayıp	Шур сухалне якатса
Konuştu yavaş yavaş	Каларӗ вӑл ерипе
Yaşlı kadına bakıp	Карчӑк енне çаврӑнса
Dert yarası kapanmaz	Çaмки шӑтӑк— хупӑнмӗ 
İç yarası yapışmaz	Чӗри татӑк сыпӑнмӗ
Tanrının verdiğinden	Пўлӗх турӑ пўрнинчен
Hiçbir zaman kaçılmaz	Нимӗнпе те иртеймӗ
Vermiş ona tanrımız	Панӑ ӑна пўлӗхçӗ
Sıcak kan  yumuşak can	Вӗри юнпа çемçе чун
Vermiş ona tanrımız	Пўрнӗ ӑна пўлӗхçӗ
Kısa ömür  zor yaşam	Кӗске ӗмӗр йывӑр кун
Soğuk günler gelecek	Сивӗ кунсем килӗç те
Donacak sıcak kanı	Шӑнса кайӗ вӗри юн
Kötü günler gelecek	Хытӑ кунсем килӗç те
Katılaşacak canı	Хытса кайӗ çемçе чун
Sıcak günler gelecek	Вӗри кунсем килӗç те
Donmuş kan kaynayacak	Вӗриленӗ шӑннӑ юн
Katı cansa eriyip	Хытнӑ çӗртен ирӗлсе
Yanıp gidiverecek	Çyнca кайӗ çемçе чун
Sonra ihtiyar susup	Унтан старик чарӑнса
Düşünerek kalktı da	Шухӑшласа тӑчӗ те
Kürküyle şapkasını	Кӗрӗкӗпе çӗлӗкне
Koydu seki üstüne	Сакки çине хучӗ те
Ve sonra şöyle dedi	Çaплa татах каларӗ
Yaşlı kadına dönüp	Карчӑк енне çаврӑнса
Oturuyor sekide	Ларать карчӑк сак çинче
Sağa sola sallanıp	Урлӑ пирлӗ тайӑлса
Türlü kötülük değil	Тӗрлӗ усал  тӗсел мар
Kötü ruh işi değil	Киреметри хывни мар
Hastalık değmiş değil	Чир чӗр ертен йӗрӗх мар
Büyü yapılmış değil	Çын тухатса хуни мар
Yok gelinim oğluna	Çyк кин санӑн ы вӑлна
Böylece yazmış tanrı	Турӑ çырни çплалла
Ağlama gelin  tanrıya	Ан йӗр кинӗм пулӗхçе
Nasıl gelinir karşı	Епле хирӗç пымалла
İhtiyar bunu dedi	Старик çапла каларӗ
Ne yapsın bilemedi	Нимӗн тума пӗлм ерӗ
Tekrar işine döndü	Хӑйӗн ӗçне ты трӗ те
Başka söz söylemedi	Пӗр сӑмах та чӗнмерӗ
Başı eğik ve üzgün	Пуçне усса хурланса
Gitti zavallı kadın	Тухса кайрӗ карчӑкӗ
Çizmesiyle başbaşa	Çӑпа тине сапласа
Kaldı ihtiyar falcı	Ларса юлчӗ старикӗ
Söylenip  homurdanıp	Мӑкӑртатса мӑшлатса
Şaşkın şaşkın oturdu	Аптӑраса ларать вӑл
Ne kadar sonra bu gün	Мӗнле вара ку паян
Diye kendine sordu	Хӑй ӑшӗнче ыйтать вӑл
Şimdiye dek herkese	Халичченех çынсене
Fal açıp bakıyordum	Юмӑç пӑхса параттӑм
Yalan sözler söyleyip	Суя сӑмах суяйса
Aldatıp gidiyordum	Улталаса яраттӑм
Ne kadar sonra bu gün	Мӗнле вара ку паян
Kalp gerçeği bildi mi	Чӗре чӑнах пӗлчӗ шим
Yalan diye dediğim	Суйса napac тенӗччӗ
Ah ne yazık doğru mu	Aк тамаша тӗрӗс шим
Kaçış	Тарни
Güneş kaybolduğunda	Хӗвел анса пытанать
Silpi köyü susuyor	Силпи ялӗ лӗпланать
Karanlık erişince	Тӗттӗм пулса Çитecne
Düğün de dağılıyor	Пирӗн туй та саланать
Kızlar  yiğitler köyde	Ялти хӗрсем качч асем
Çıkmışlar oynamaya	Вӑййа тухнӑ выляма
Çıkmış bizim Narspi de	Тухнӑ пирӗн Нарспи те
Kız ömrünü savmaya	Хӗр ӗмӗрне ӑсатма
Son geceyi oyunla	Юлашки кaç выляса
Geçirip de gidecek	Юлас арӑм пуличчен
Son gece Setner’ini	Юлашки кaç Сетнере
Görecek  el olacak	Курас юта кайиччен
Setner durur öylece	Сетнер тӑрать çaвӑнтах
Başını eğmiş  üzgün	Пyçнe усса хуйхӑрса
Sarı kızın gözleri	Сарӑ хӗрӗн куçӗнчен
Yaş akıtıyor  süzgün	Анать куççулӗ юхса
Konuklar dağılınca	Вӑйӑ çЫнни салансан
Bir süre konuştular	Пайтах вӗсем калаçрӗç
Sarılıp birbirine	Ыталаса пӗр пӗрне
Gecede kayboldular	Тӗттӗм çӗрте çухалчӗç
Minik yıldızlar gökte	Вӗт çӑлтӑрсем тaxçaнax
Söndü bulut altında	Пӗлӗт айне хупланчӗç
Orman yeri kapkara	Вӑрман тӗлне хуп хурах
Kaplandı bulutlarla	Сӗм пӗлӗтсем капланчӗç
Yağmur yağar  sel akar	Çyмӑр çӑвать шыв юхать
Kara orman gürülder	Хура вӑрман кӗр  кӗрлет
Rüzgar eser de sanki	Çил тухать те çил каять
Aç kurtlar gibi ulur	ВЫçӑ кашкӑр пек ўлет
Şimşekler ışıtıyor	Çиçӗм пӗрмай çуттипе
Orman karanlığını	Вӑрман ӑшне çутатать
Kara orman içinde	Тӗттӗм вӑрман ӑшӗпе
Koşuyor binek atı	Пӗр юланут кустарать
Koşan atın soluğu	Лаша пырать тӑлхӑрса
Ormanda yankılanır	Вӑрман ӑшне янратса
Atta iki kişi var	Иккӗн ларнӑ утланса
Artık gücü kesilir	Лаша çнtet ывӑнса
Ağaçlar devler gibi	Йывӑç ларать улӑп пек
Gecede hışırdıyor	Тӗттӗм çӗрте кашласа
Güzel gidiniz  diye	Чипер кайӑр  тиет те
Baş eğip yol veriyor	Пуçне таять çул парса
Tan yeri ağarıyor	Шурӑмпуçӗ çап  çутах
Nerdeyse gün doğuyor	Хӗвел тухас пек тӑрать
Tan yeri ağarınca	Шyрӑмпуçӗ шурсанах
İnsanlar toplanıyor	Туй халӑхӗ пухӑнать
Sırayla dansediyor	Хӑй йӗркипе ташлама
Önce delikanlılar	Вӑхӑт пуса каччисен
Sonra şarkı söylüyor	Хӑй йӗркипе юрлама
Vakti gelince kızlar	Вӑхӑт çитнӗ хӗр çум сен
Saz sesi duyulmuyor	Шӑпӑр сасси илтӗнмест
Çalgıcı görünmüyor	Шӑпӑрçи те курӑнмасть
Konuklar arasında	Ырӑ хӑна хушшинче
Rakı  şarap bitmiyor	Эрех сӑра такӑнмасть
İhtiyarla karısı	Стариккипе карчӑкки
Evde tartışıyorlar	Хура пўртре вӑрçаççӗ
Ne oldu ki bu türlü	Мӗн пулнӑ ши çaв тӗрлӗх
Sessiz bekleşiyorlar	Пурте шӑппӑн лараççӗ
Hiç çıkmıyor sesleri	Шӑппӑн шӑппӑн лармасӑр
Kızlan kayıp bugün	Вӗсен хӗрӗ çук паян
Kötü Setner’le Narspi	Нарспи усал Сетнерпе
Kaçıp gitmiş düğünden	Тарса кайнӑ вӑйӑран
Üç tane at ormanda	Виç юланут вӑрманта
İz sürerek koşuyor	Йӗр йӗрлесе çўреççӗ
Her tarafa bakınıp	Пӗри кунта леш унта
Bir tane iz arıyor	Темӗнле йӗр йӗрлеççӗ
Arayıp dinliyorlar	Йӗр йӗрлеççӗ итлеççӗ
Bir ses duyulacak mı	Пӗрер сасӑ пулмӗ ши
Güneş aydınlatınca	Хӗвел пӑхатьçyтaтca
Yollar açılacak mı	Кирлӗ çула уçмӗ ши
Görünmez hiçbir nesne	Анчах нимӗн паллӑ мар
İçerlere girince	Кӗрес тата шаларах
Burunlarında öfke	Вӑрçас килет çиллипе
Bulalım bir an önce	Тупасчӗ çке хӑвӑртрах
Orman vahşi  orman sık	Вӑрман çӑра пит тискер
Kuş sesi cıvıl cıvıl	Унӑн ӑшӗ чӑв та чав
Hiç bir yerde bir iz yok	Йӗр ниçта та паллӑмар
Bir yere gitmek müşkül	Ниçта кайма аптӑрав
Üç tane at ormanda	Виç юланут вӑрманта
İz sürerek koşuyor	Йӗр йӗрлесе çўреççӗ
Bakınıp her tarafa	Пӗри кунта леш унта
Bir tane iz arıyor	Темӗнле йӗр йӗрлеççӗ
Setner tatlı uyuyor	Сетнер тутлӑ çывӑрать
Yüksek meşe kökünde	Çўnӗ юман кутӗнче
Narspi rüya görüyor	Нарспи ларать тӗлӗрсе
Setner’in baş ucunda	Сетнер пуçӗ вӗçӗнче
Narspi görür rüyada	Нарспи тӗлӗк тӗлленет
Köpek olmuş babası	Ашшӗ йытӑ пулнӑта
Takırdayan dişlerle	Шӑлӗсемпе шаккаса
Dolaşıyor ormanı	Сиксе çўрет вӑрманта
Kötü kız nere kaçtın	Ӑçтa тартӑнь усал хӗр
Yerim başını bulur	Пуçна çийӗп тупӑнсан
Altında it babanın	Йытӑ ури айӗнче
Kara orman çatırdar	Шатӑртатать сӗм вӑрман
İşte  işte geliyor	Çывӑx çывӑх ак çитет
Narspi birden uyanır	Нарспи ялтах вӑранать
Bakar Onlara doğru	Пӑхать хӑйӗн патнелле
Üç tane at yaklaşır	Виç юланут кустарать
Setner  Setner  Kalk artık	Сетнер Сетнер  тытрӗç  çке
Kalk  kalk  Kaçıp gidelim	Тӑр тӑр тарса хӑтӑлар
Ah  bittik  işte bittik	Ай пӗтрӗмӗр пӗтрӗмӗр
Nereye gizlenelim	Ӑçтa тарса пытанар
Bugün yiğit çalgıcı	Маттур шӑnӑpçӑ паян
Ve iki delikanlı	Икӗ пуса каччипе
Ormanda yakaladı	Тытса килчӗç вӑрмантал
Setner ile Narspi’yi	Сетнерпеле Нарспие
Anne dışarı koştu	Карчӑк вӗçсе тухрӗ те
Saçından yakaladı	ÇўçpeН яврӗ Нарспине
Babası koşup çıktı	Старик чупса тухрӗ те
Setner’i yumrukladı	Чышкӑ пачӗ Сетнерне
Ey annem  anneciğim	Эй аннеçӗм аннеçӗм
Saçımdan sürükleme	Мана çўçрен ан сӗтӗр
Bana bunları yapıp	Мана апла вӗрентсе
Benden sevgi bekleme	Манран ырӑ ан кӗтӗр
Ey Miheter babacık	Эй Михетер асатте
Yararı yok cezanın	Хӗненипе усси çук
Cezalandırıp beni	Эсӗ мана хӗнесе
Külü kor yapamazsın	Кӗлрен вутӑ тӑвас çук
Azgın köpek Miheter	Урнӗ йытӗ Михетер
Çekti de kırbacını	Хӑй саламат йӑтрӗ те
Isırmaya çalışıp	Тытӑнчӗ çке тулама
Setner’ini bağladı	Çыxca хунӑ Сетнере
Avlu insanla dolu	Карташӗнче çын нумай
Sanki düğün var gibi	Туйне курма килнӗ пек
Setner kara toprakta	Хура тӑпра çийӗнче
Yatıyor ölmüş gibi	Выртать Сетнер вилнӗ пек
Annesi de orada	Амӑшӗ те çавӑнтах
Ağlayıp haykırıyor	Тӑрать йӗрсе ылханса
İki kişi alıp da	Ярать ӑнсӑр ывӑлне
Oğlunu götürüyor	Икӗ çынна йӑттарса
Narspi’nin kara evde	Хура пўртре Нарспине
Yüzü gözü yunuldu	Питне куçне çӑваççӗ
Duvağı da takılıp	Татах пӗркенчӗк айне
Kondu perde ardına	Чаршав хыçне лартаççӗ
Dans edip oynayarak	Тӑпӑр тӑпӑр тӑпӑртӑк
Haydi düğün yapılsın	Атьӑр шепрех туй тӑвар
Dün gece olanları	Анчах хальхи ӗq çинчен
Yeni güvey duymasın	Çeн кӗрӗве калас мар
Bak düğün  işte düğün	Акӑ туй та çакӑ туй
Büyük de bozuk düğün	Пысӑк туй та пасӑк туй
İki Düğün	Икӗ Туй
Kızgın güneşi yazın	Çypкyннexи вут хӗвел
Sönmeye yüz tutunca	Каç еннелле сулӑнать
Köy ucundaki orman	Ял вӗçӗнчи сӗм вӑрман
Yankılandı usulca	Темӗншӗн пит янӑрать
Köylüler bekler çoktan	Халӑх кӗтет тахçанах
Önünde kapıların	Анат хапха патӗнче
Hissedildi oradan	Туй килнине çавӑнтах
Gelen düğün alayı	Систерчӗçӗ евӗче
Mağrur yürüyüşüyle	Кӗпӗр кӗпӗр сиктерсе
Gelip çıktı ormandan	Килсе тухрӗ вӑрмантан
Herkesten daha önde	Ыттисенчен маларах
Yeni güvey Tĭhtaman	Çӗнӗ кӗрў Тӑхтаман
Göz kısık burnu yassı	Лаптак сӑмса хӗсӗк куç
Boz saç  sarı sakallı	Сӑрӑ çўçпе cap сухал
Uçuyor sanki atı	Лаши вӗçсе пырупа
Yüzü gözü çok kötü	Пичӗ куçӗ пит усал
Şapka boz  giysi kara	Хура сӑхман сарӑ çӗлӗк
Alnı üstünde para	Çaмкн çинче тенкӗпе
Beyaz çorap ve çizme	Шурӑ чӑлха  çӑпата
Pek yakışmış güveye	Пит килӗшет кӗрӗве
Alay türkü söyleyip	Арçын туйӗ юрласа
Sokak boyunca varır	Урам тӑрӑх уттарать
Kapıları dünürün	Ырӑ евчӗн хапхисем
Açılır da kapanır	Уçӑлать те хупӑнать
Kız tarafı yukardan	Хӗр туйӗ те тукасран
Karşılamaya iner	Хирӗç анать çӗмӗрсе
Narspi duvak altından	Нарспи тутӑр айӗнче
Gözyaşlarını döker	Тӑрса пырать хӗр йӗрсе
Sarı kızın yüreği	Capӑ хӗрӗн чӗрнинче
Ateşlerde yanıyor	Вутра çyннӑ пек çунать
Yaşlı güveyi görüp	Ватӑ каччине курса
Kederinden eriyor	Нарспи хытӑ хурланать
Ey annecik ey baba	Аттеçӗм аннеçӗм
Niçin kıydınız bana	Мӗншӗн çирӗр хӗр пуçне
Niçin verdiniz beni	Мӗншӗн патӑр хӗрӗре
Yedi kat yabancıya	Çиyӗ ютӑн аллине
Ey nişanlım Tĭhtaman	Эй каччӑмçӑм Тӑхтаман
İyi günler bekleme	Манпа ырӑ курас çук
Ölecek bile olsam	Эпӗ чунӑм пӗтсен те
Olmayacağım senle	Санпа пӗрле пулас çук
İyi dünür şarapla	Ырӑ евчӗ сӑрапа
Karşılamaya gider	Туя хирӗç вӑл тухать
Huşĭlkalı güvey de	Хушӑлкасен мӑн кӗру
Şiirlerini söyler	Хӑй такмакне вӑл калать
Elindeki şarabı	Хӑй аллинчи сӑрана
Döküp ayak vuruyor	Тӑка тӑка çаптарать
Tek durmaz kara atı	Хура лаша тӗк тӑмасть
Güveyi çok istiyor	Çӗнӗ кӗрў çунтарать
Yeni güvey yanında	Çӗнӗ кӗрў çумӗнче
Yedi at dans ediyor	Çичӗ юланут ташлать
Köyü yıkacak gibi	Пӗтӗм яла çӗмӗрсе
Bağırıp ant içiyor	Çӑвap карса антӑхать
Yeni kapı altından	Çӗнӗ хапха айӗнчен
Bitmez giren araba	Кӗрсе пӗтмест урапа
Güvey kapıyı çalan	Хапха трри шатлатать
Vurarak kırbacıyla	Саламатпа çaпyпa
İyi dünür evinde	Ырӑ евӗчӗ килӗнче
Büyük düğün yapıldı	Туйне турӗу ытлашши
Ertesi gün sokakta	Тепӗр кунне урамра
Vîy killi de yapıldı	Турӗç ялта вӑй килли
Üç gün düğün yaptılar	Турӗç туя виçӗ кун
Huşĭlkalı konuklar	Хушӑлкари хӑтасем
Fakat öbür gün gidiş	Анчах кайма тепӗр кун
Vakti diyor  konuklar	Bӑxӑт теççӗ хӑнасем
Düğün alayı kalkmış	рçын туйӗ пуханать
Huşĭlka’ya gidiyor	Хушалкана каяс тет
Orada da düğün var	Кунта туя турӑмӑр
Şimdi gidelim  diyor	Ӗнтӗ киле тарас тет
Etmeyiniz acele	Ан васкӑр ха хӑтасем
Gidersiniz nasılsa	Тепӗр киле каяр ха
Gidinceye dek haydi	Халех киле кайиччен
Eğlenelim iyice	Туя шепрех тӑвар  ха
Ve sonra bir kez daha	Татах тепӗр тапхӑрне
Eğlendiler iştahla	Туйне турӗç çунтарса
Sonunda dünürlerde	Юлашкинчен хӑтасен
Güç kalmadı oyuna	Халӗ пӗтрӗ туй туса
Erkek tarafı hazır	Арçын туйӗ пухӑнса
Artık eve gidiyor	Килне кайма хускалчӗ
Uğurlamak için de	Каян туя ӑсатма
Bütün köy toplanıyor	Пӗтӗм Силпи пухӑнчӗ
Mezarlığın yanında	Аслӑ масар тӗлӗнче
Hazır düğün atları	Туй лашисем Tӑpaççӗ
Uğurlamak için de	Хӗрин туйне ӑсатма
Gidiyor anne baba	Ашшӗ амӑш nЫpaççӗ
Çevredeki köylüler	Туйӗ тавра ялйышсем
Kıpırdaşıp duruyor	Кӗпӗртетсе тӑраççӗ
Yaşlıları anarak	Ваттисене асӑнсан
Narspiyi yol ediyor	Хӗр кайнине сӑнаççӗ
Dertli Setner orada	Чирлӗ Сетнер çавӑнтах
Duruyor annesiyle	Тӑрать хӑйӗн амӑшпе
Sevgilisi Narspiyi	Чун савнине Нарспине
Arıyor gözleriyle	Шырать чирлӗ куçӗпе
Miheterle karısı	Михетерпе карчӑкки
Narspiyi kutsadılar	Пехиллерӗç xӑй хӗрне
Ağlayıp tüm dostları	Мӗнпур тантӑша йӗртсе
Yaşlarını döktüler	Тӑкрӗç ӑшӑ куççӗльне
Tek bir söz bile kıza	Савнӑ хӗрне сӑмах та
Demediler utançtan	Каламарӗç намӑсшӑн
Setner ile ormana	Сетнерпеле вӑрмана
Kaçıp gittiklerinden	Намӑс туса тарнӑшӑн
Kutsama da bitince	Пехиллесен мӗн тусан
Alay hareket etti	Кайрӗ туйӗ хускалса
Setnere doğru bakıp	Сетнер çине пӑхрӗ те
Narspi ağlayıp gitti	Нарспи кайрӗ макӑрса
Alay uzaklaşınca	Туй кайсассӑн тахçанччен
Çınladı kara orman	Янтӑрарӗ сӗм вӑрман
Herkes döndü evine	Ялйыш утрӗ килнелле
Düğün de erdi sona	Туйӗ куçран çухалсан
Annesiyle Setner de	Амӑшӗпе Сетнер те
Eve yürüdü üzgün	Килне утрӗç хуйхӑрса
Onu sevgilisinden	Чун савнинчен ӗмӗрех
Ayırmışlardı bugün	Ячӗç ӑна уйӑрса
Ey hayat  ey hayatım	пурӑнӑç пурӑнӑç
Ölüm kaldı geriye	Вилме анчах юлчӗ çав
Ey hayat  Narspi artık	пурӑнӑç Нарспи те
Gitti yabancı ele	Çичӗ юта кайрӗ çав
Onsuz ben ne yaparım	Унсӗр пуçне мӗн тӑвас
Şu talihsiz halimle	Арӑскалсӑр пу çӑмпа
Nerelere varırım	Ӑçтa кайса кӗрес ха
Şu dertli yüreğimle	Хамӑн усал хуйхӑмпа
Narspi gitti yad ele	Нарспи кайрӗ ют яла
Setner gitti evine	Сетнер утрӗ хӑй килне
İki can da sevmiş can	Икӗ чун та савнӑ чун
Yenildiler düşmana	Çӗнеймерӗç Тӑшманне
Bu iki sevgiliyi	Икӗ савни тарнине
Saklayamadı orman	Хуплаймарӗ сӗм вӑрман
Sarı kızı  Narspiyi	Сарӑ хӗре Нарспие
Alır almaz Tĭhtaman	Илчӗ илчех Тӑхтаман
Kalakaldı çaresiz	Тӑрса юлчӗ кӑлӑхах
Setner  o çok sevdiği	Сетнер çавтер чун савни
Tanrı yazmış mutlaka	Турӑ çЫpни axӑpax
Böyle imiş bu dünya	Çaплa тӑp çaв самани
Köyde onlar hakkında	Ялта нумай ун çинчен
Şöyle böyle dediler	Урлӑ пирлӗ калаçрӗç
Çok akıllılar bile	Темтер ӑслӑ çЫнceм те
Bunu çözemediler	Кутне nyçнe тупмарӗç
Narspi gitti yad ele	Нарспи кайрӗ ют çӗре
Setner çaresiz kaldı	Сетнер юлчӗ кӑлӑхах
Baba üzdü kızını	Ашшӗ çирӗ хӑй хӗрнех
Dostlar da dostlarını	Тӑван çирӗ тӑванах
Huşĭlkada	Хушӑлкара
Huşĭlkada var düğün	Хушӑлкара туй иккен
Çok iyi de bir düğün	Туйӗ ытла шеп иккен
Böyle düğün yapıyor	Шур сухаллӑ Тӑхтаман
Ak sakallı Tĭhtaman	Туйне тӑвать тет иккен
İyi güvey Tĭhtaman	Чипер каччӑ Тӑхтаман
Silpi kızını sarmış	Силпи хӗрне çаклатнӑ
Böyle güzel bir çifte	Çaвтep аван мӑшӑра
Çok güzel düğün yapmış	Урӑм  çypӑм туй лартнӑ
Dansedip oynuyorlar	Туй тӑваççӗ ташласа
Güveyin genç dostları	Çaмpӑк пуса каччисем
Türküler söylemekten	Туй юррисем юрласа
Yorulmuş ağızları	Ывӑнаççӗ çӑварсем
Akşam Silpi köyünden	Ӗнер Силпи ялӗнчен
Alay geldi dönerek	Туйӗ килчӗ таврӑнса
Bugün gelin alayı	Паян кӗру хӗр туйне
Bekleniyor coşarak	Кӗтет хӗру туй туса
Kız tarafı gelince	Паян хӗр туйӗ килсен
Gece odaya koymalı	Kaçna хӗве хупмалла
Yarın erken kalkmalı	Ыран ирех тӑмалла
Kızdan kadın yapmalı	Хӗртен арӑм тумалла
Büyük bir köy Huşĭlka	Аслӑ ял та Хушӑлка
İki dağ arasında	Икӗ тӗван хушшинче
Düğün yapan Tĭhtaman	Туйне туса Тӑхтаман
Oturuyor masada	Ларать сӗтел хушшинче
Türlü yemek altında	Тӗрлӗ апат айӗнче
Masalar eğiliyor	Çӑкa сӗтел авӑн ать
Sarhoş güvey başında	Ўсӗр кӗрў пуçӗнче
Dünya fır fır dönüyor	Тӗнче вӑр  вӑр çаврӑнать
Güneş parlar dışarda	Тулта хӗвел çутатать
Güneye salınarak	Кӑнтӑрлана сулӑнать
Başı düşer içkiden	Кӗру пуçӗ ўсӗрпе
Aşağı asılarak	Аялалла усӑнать
Bozkırda bir bıldırcın	Çeçeнxиpтe путене
Zaman zaman ötüyor	Вӑхӑт вӑхӑт вӑл юрлать
Alay gecikti diye	Туй килмест и ха тесе
Güvey bezgin duruyor	Текех кӗру йӗтетет
Giydiği ak gömleğin	Кӗру çинҷи шурӑ кӗпен
Eteği fır dönüyor	Арки вӑр  вӑр тӑватъ çке
Alayı bekler iken	Туя кӗтсе ватӑ пуçӑн
Canı pır pır ediyor	Чунӗ вӑр  вӑр тӑвать çке
Çıngır çıngır çıngırak	Шӑнкӑр шӑнкӑр шӑнкӑрав
Çıngırdıyor yol boyu	Шӑнкӑртатать çулпала
Düğün alayı gelir	Хӗр туй килет çӗмӗрсе
Sokak gürültü dolu	Урам тӑрӑх ялпала
Tepelikli on kadın	Вунӑ арӑм хушпупа
Gelin arabasında	Сӑран кўме çийӗнче
Kırk üç tane araba	Хӗрӗх виçӗ урапа
Dizilmiş arkasında	Сӑран кўме хыçӗнче
Yedi yerde sokakta	Çичӗ çӗрте урамра
Durdu düğün alayı	Чарӗнчӗç туй çыннисем
Şarabıyla karşıda	Хирӗç тухрӗç сӑрапа
Eş dostlar  Huşĭlkalı	Хушӑлкари тантӑшсем
Türküyle giriyorlar	Юрлаççӗ те кӗреççӗ
Güveyin kapısından	Ырӑ кӗрў хапхинчен
Yiyorlar içiyorlar	Ӗçеççӗ те çиеççӗ
Uzun yolun ardından	Инçe çулсем хыçӗнчен
Daha öğlen olmamış	Кӑнтӑрла та çитмен ха
Geceye çok zaman var	KaçҷeН вӑхӑт нумай ха
Düğünü yapmak için	Kaç пуличчен туй тума
Bize de çok zaman var	Пире вӑхӑт нумай ха
Şıv şur puśi başlayıp	Шыв шур пуçӗ пуçласан
Akşama dek oynandı	Тӗттӗмчченех сикрӗç те
Tĭhtamanla Narspi kız	Тахтаманпа Нарспие
Odaya kapatıldı	Хӗве хупрӗç кӗлете
Akıllı insanlar da	Аслӑ Çынceм уçӑпах
Kilitledi kapıyı	Питӗрчӗç туй кӗлетне
Gizlice güle güle	Йӑл йӑл кула кула çeç
Gittiler evlerine	Кӗрсе кайрӗç пўртнелле
İşte bir delikanlı	Акӑ каччӑ пӗр каччӑ
Çevrede dolanıyor	Кӗлет тавра явӗнать
Dinleyip gözlemeye	Те итлеме те пӑхма
Uygun bir yer arıyor	Пушӑ вырӑн вӑл шырать
Dört beş küçücük çocuk	Тӑват пилӗк ача пӑча
Dolaşıyor orada	Явӑна ççӗ çaвӑнтах
Be  utanmaz çocuklar	Ай намӑссӑр ача пӑча
Ne işiniz var orda	Мӗн кирлиех пур унта
Bak işte dinliyorlar	Анчах акӑ итлеççӗ
Duyuluyor olmalı	Илтӗнет те пулмалла
İşte sustu çocuklar	Авусалсем лӑпланчӗç
Dinle  gürültü yapma	Хӗр кал аçатъ ан шавла
İçerde Narspi bir şey	Шалта Нарспи темӗскер
Söyledi Tĭhtamana	Тӑттамана каларӗ
Alçak sesle konuştu	Анчах хуллен сӑмахне
Hiç bir şey duyulmadı	Пӗртте илтсе пулм арӗ
Narspi bil ki  dizginin	Асту Нарспи йӗвену
Artık benim elim de	Ман алӑра малашне
Dedi sertçe Tĭhtaman	Терӗ хытах Тӑхтаман
Kapılıp öfkesine	Чараймасӑр çиллине
Düğünüm yeni bitti	Туйна анчах ӑсатам
Beni tanıyacaksın	Унта мана пӗлӗн  çкe
Ne olur bilmiyorsun	Мӗн пуласне пӗлме çук
Gözünle göreceksin	Ху курасне курӑн  çкe
Başka bir ses çıkmadı	Урӑх нимӗн илтӗнмест
Tek söz işitilmedi	Пӗр сӑмах та чӗнмерӗç
Dinleyenler bekledi	Итлекенсем кӗтсен те
Hiçbir şey duyulmadı	Пӗр сӑмах та илтмерӗç
Çoluk çocuk oradan	Ачи пӑчи çaвӑнтах
Evlerine koştular	Ашшӗ килне чупаççӗ
Duydukları sözleri	Илтни çинчен çaв хутрах
Bütün köye yaydılar	Ялта сӑмах сар аççӗ
Bunu duyan sarı genç	Илтен  тӑран cap каччӑṳ
Ormana dek yürüdü	Вӑрманалла уттарчӗ
İşittiği sözleri	Хӑлха илтнӗ сӑмаха
Yüreğinde gizledi	Хӑй ӑшӗнче пытарчӗ
Öfkeli gözlerinden	Ун çилӗллӗ куçӗнчен
Sanki ateşler aktı	Йӑлтӑр  ялтӑр вут кайрӗ
Giren çıkan köylüler	Кӗрен тухан ялти çын
Hiç yüzüne bakmadı	Каччӑ çине пӑхмарӗ
Yalnız  meşe  ormanda	Юман анчах вӑрманта
Bir dost gibi davrandı	Хӑй кўршине систерчӗ
Ormana giren bu genç	Çaв вӑрмана кӗнӗ çын
Kardeşimiz Setnerdi	Пирӗн тӑван Сетнерчче
Evde  masa üstünde	Пўртре сӗтел çийӗнче
Çorba buğulanıyor	Пӑтӑ пӑсне кӑларать
Yeni güvey Tĭhtaman	Çӗнӗ кӗрў Тӑхтаман
Misafir ağırlıyor	Хӑнасене ӑсатать
İyi güvey Tĭhtaman	Ырӑ кӗрў Тӑхтаман
Düğün çorbası ile	Туй пӑттипе сӑйласа
Herkesi selamlıyor	Туй халӑхне nyç таять
Şöyle sözler söylüyor	Çariлa сӑмах каласа
Alınmayın konuklar	Ан ўпкелӗр хӑтасем
Çokça değil ikramım	Сӑйӑм питех нумай мар
Yiyin için can dostlar	Ӗçӗр  çийӗр тӑвансем
Hep birlikte olalım	Ӗмӗр пӗрле пурӑнар
Konuklar sarhoşlukla	Виле ўсӗр хӑтасем
Çok zor konuşuyorlar	Урӑм  çypӑм кӗрлеççӗ
Sarhoş olsalar bile	Bиле ўсӗр пулсан та
Sözünü biliyorlar	Мӗн каласне пӗлеççӗ
Güveyimiz Tĭhtaman	Кӗрўçӗм Тӑхтаман
Sana kırgın değiliz	Сана ўпкев çyк пиртен
Kızımıza iyi bak	Пирӗн хӗре хытӑ пӑх
Öm rünün sonuna dek	Тату пулӑр виличчен
Avlu içinde atlar	Карташӗнче лашасем
Kıpır kıpır kıpraşır	Тӑраççӗ   çкe ташласа
Çıkıp giden konuklar	Тухса кайрӗç хӑтасем
Güzel türküler söyler	Ырӑ юрӑ юрласа
Gel gidelim yol boyu	Атьӑр каяр çулпала
Kupamız balla dolu	Курка тулли пылпала
Arabalar ardından	Ураписем хыçӗнчен
Toz yükseldi yol boyu	Тусан кайрӗ çулпала
Çıngırakları çınlar	Ав шӑнкӑрав янӑрать
Silpiye doğru koşar	Силпиелле чуптарать
Atlar başını eğmiş	Лаши чупать nyç ухса
Sarhoşları kovalar	Ўсӗр xyçи хӑвалать
Düğün alayı artık	Туй п ӗтрӗ те туй каять
Düz yolda koşturuyor	Такӑр çулпа чуптарать
Bir yaşlı rastgelince	Пӗрер ватти тӗл пулсан
İyi günler diliyor	Тавси тавси кӑшк ӑрать
Giden alayın sesi	Каян туйӑн сассине
Narspinin kulağında	Нарспи юлчӗ итлесе
Uzakta  uzaklarda	Taçтa тaçтa инçeтpe
Tozlar yükselir göğe	Тусан кайрӗ çӗкленсе
Śilmik Geçince	Çимӗk Иртсен
Geçti śimîk ve düğün	Иртрӗ çимӗк иртрӗ туй
Geçti düğün neşesi	Иртрӗ туйри савӑнӑç
Günler günleri izler	Кайрӗ пӗр пек тӑсӑлса
Hayat sürer de gider	Кунран кунах пурӑнӑç
Tarlada  saban ile	Хирте ака айӗнче
Çayır yer yer kesilir	Çӗрӗм лӑп лӑп касӑлать 
Üzüntüyle  kederle	Усал хуйхӑ суйхӑран
Narspinin içi erir	Нарспи чунӗ касӑлать
Tırpanların altında	Хирте çaвa айӗнче
Taze otlar devrilir	Курӑк вӑш ваш йӑванать
Üzüntüden  kederden	Усал хуйхӑ суйхӑран
Kızın başı eğilir	Нарспи пуçӗ усӑнать
Günden güne dünyayı	Куллен кунах тӗнчене
Gün ışığı yakıyor	Хӗвел хӗртнӗçӗм хӗртет
Günden güne üzüntü	Хуйхӑ суйхӑ кунран кун
Narspiyi kemiriyor	Нарспи чӗрине çиет
Her gün  her gün kamçı da	Куллен кунах саламат
İner zaten duvardan	Анать ӗçке патаран
İşte böyle tutuyor	Хытӑ тытать пулмалла
Karısını Tĭhtaman	Хӑй арӑмне Тӑхтаман
Güzel çocuk Sentti var	Чипер ача Сентти пур
Koşup oynar sokakta	Чупса çўpeт урамра
Sopasını at yapıp	Кӗвентине утланса
Atlar sonar üstüne	Ача вы лять лаш алла
Uzun sokak boyunca	Аслӑ урам тӑршшӗпе
Toz kaldırır havaya	Чиксӗр тусан кӑларать
Çingene gibi kara	Хура чикан пек хура
Döner eve akşama	Kaçna килне таврӑнать
Güzel çocuk Sentti var	Чипер ача Сенти пур
Koşup gelir atıyla	Чупса килет лашипе
Küçük diliyle öper	Хӑйӗн пӗчӗк чӗлхипе
Yengesini sevgiyle	Пакӑлтатать инкӗшпе
Yeni gelin Narspi kız	Çӗнӗ çын та Нарспи кин 
Sürekli yaş döküyor	Пӗрмаях вӑл хуйхӑрать
Kaynının çocuğunu	Пӑяхӑшин ачине
Tek Senttiyi seviyor	Сенттие çeç юратать
Yeni gelin Narspi kız	Çӗнӗ çын та Нарспи кин
Sürekli yaş döküyor	Пӗрмаях вӑл хуйхӑрать
Sentti ile konuşup	Сенттипе çeç калаçса
Kendini avutuyor	Хӑй хуйхине пусарать
Böyle güzel çocuğa	Çaвтep ырӑ ачана
Tanrı can vermiş işte	Турӑ чунне панӑ çae
Gül  zıpla  oyna diye	Кулса сиксе выляма
Kuş canı vermiş işte	Кайӗк чунӗ янӑ çaв
Yedi yaşında çocuk	Çичӗ çулхи ачара
Çuvaş canı taşıyor	Чӑваш чунӗ ларать çaв
Minik gözü ağlasa	Пӗчӗк куçӗ йӗрсен те
Dudakları gülüyor	Йӑваш тути кулать çaв
Güzel çocuk Sentti var	Чипер ача Сентти пур
Narspiye atılıyor	Инкӗш патне ӑнтӑлать
Minicik dili ile	Хӑйӑн пӗчӗк чӗлхипе
Yengeyi avutuyor	Инкӗшне вӑл йӑпатать
Ağlama yengeciğim	Ан йӗр инкем ан йӗрсем
M endille sil gözünü	Тутӑрупа шӑл кyçнa
Üzülme yengeciğim	Ан хуйхӑрсам  инкеçӗм
Kovala kederini	Хӑваласам хуйхӑна
İyi güvey Tĭhtaman	Ырӑ кӗру Тӑхтаман
Düğünü anımsıyor	Туй кӗлетне астӑвать
Her gün  her gün eşini	Куллен кунах арӑмне
Kırbaçla inletiyor	Саламатпа кастарать
Zavallı kız katlanır	Мӗскӗн арӑмӗ тўсет
Sessizce acılara	Асапсене чӗнмесӗр
Aptal kocası döver	Ухмах упӑшка хӗнет
Aldırmadan sonuna	Мӗн пуласне пӗлмесӗр
Bir gün geldi bir konuk	Пӗрре пӗр Çын килчӗ те
Tĭhtamanla konuştu	Тӑхта анпа калаçрӗç
Narspi evde değilken	Нарспи пўртре çук чухне
Olanları anlattı	Пӑшӑл пӑшӑл калаçрӗç
Narspi geldi şarapla	Нарспи кӗчӗ сӗрапа
İkram etti konuğa	Леш хӑнана ӗçтерет
Kalkıp gidince konuk	Хӑна тухса кайсанах
Sıra geldi kırbaca	Саламачӗ вӗрентет
Meğerse sen kız iken	Эсӗ апла хӗр иккен
Meğer sen Setner ile	Эсӗ апла Сетнерпе
Kaçmışsın ha ormana	Тарнӑ мӗн ха вӑрмана
Düğün yapılan yerden	Туйна тунӑ çӗртенех
Döve döve Tĭhtaman	Хӗнет хӗнет Тӑхтаман
Türlü eziyet eder	Тӗрлӗ асап кӑтартать
İnsanların dilinde	Ялти çынceн хушшинче
Dedikodular döner	Текех сӑмах сарӑлать
Bir söz de şöyle işte	Çaпли кaпли çавӑ çaв
Böylesi çok dünyada	Ун пек нумай тӗнчере
Çok kötü şeyler olur	Чылай усал ӗç пулать
Gizli yerde  gecede	Вӑрттӑн çӗрте тӗттӗмре
Baba anne kızını	Атте анне хӑй хӗрне
Severek büyütür de	Юратса çeç ўстерет
Genç kızla evlenince	Хӗртен арӑм пулсассӑн
Kıskanır yaşlı koca	Ват упӑшка кўлешет
Buldu zengin kocayı	Тупрӗ пуян упӑшка
Aile kızlarına	Атте анне хӑй хӗрне
Ama nedir yararı	Анчах унта мӗн усси
Sevgi yoksa arada	Юратмасан пӗр пӗрне
Sevgi ile dostlukla	Тату ырӑ килӗшсе
İnsanlar birleşince	Иккӗш пӗрле пурӑнсан
Yüz kat daha talihli	Çӗp хут ытла телейлӗ
Yoksul insan zenginden	Юрлӑ Çын та пуянран
Dövüp dövüp Tĭhtaman	Хӗне хӗне  Тӑхтаман
Çıkar onun canını	Чунне кӑлар унӑнне
Eziyet et Tĭhtaman	Асаплантар Тӑхтаман
Sanki köpekmiş gibi	Хурсам йытӑ вырӑнне
Döv sürekli Tĭhtaman	Хӗне хӗне Тӑхтаман
O senden genç kalmasın	Санран çамрӑк ан култӑр
Eziyet et Tĭhtaman	Асаплантар Тӑхтаман
Hemencecik yaşlansın	Нарспи часрах ватӑлтӑр
Ancak sen de ardından	Анчах кайран хӑвӑнах
Pişmanlık duymayasın	Ўкӗнмелле анпултӑр
Döv sürekli Tĭhtaman	Хӗне хӗне Тӑхтаман
O senden genç kalmasın	Санран çамрӑк ан култӑр
Geçip gitti üç hafta	Иртсе кайрӗ bнç эрне
Bayramın arkasından	Çимӗк эрни хыçӗнчен
Koca eziyetini	Ват упӑшка хӗснине
Narspi çekti durmadan	Нарспи туcрӗ çaв анччен
Fakat sonraki hafta	Анчах тепӗр эрнинче
Parlak  güzel bir gece	Пӗрре уяр ырӑ кaç
Bekleyin  söylenecek	Чим ха кӑна калама
Sırası geldiğinde	Вӑхӑтсӑрах юрамасть
Narspi İşi	Нарспи Ӗçӗ
Güneş doğar  yükselir	Хӗвел тухать улӑхать
Yüce dağlar üstüne	Çўnӗ тусем тӑррине
Sıcağını gönderir	Хӑй çуттипе ӑшӑтать
Uzak uzak yerlere	Taçти тaçти çӗрсене
Yazın bu güzel günü	Çaк çуллахи ырӑ кун
Huşĭlkayı da sarar	Хушӑлкана та савать
Dünyada tüm canlılar	Пур тӗнчери чӗрӗ чун
Danseder  oynar  zıplar	Ташлать сикет савӑнать
Güzel şarkılar söyler	Ячӗç юрӑ юрласа
Ormanda türlü kuşlar	Сӗм вӑрманти кайӑксем
Kuğu gibi salınıp	Акӑшсем пек ярӑнса
İndiler suya kızlar	Анчӗç шыва cap хӗрсем
Sadece beyaz evden	Анчах акӑ шурӑ пўрт
Bir çıt bile çıkmıyor	Пӗр сасӑ та илтӗнмест
Beyaz evdeki gelin	Шурӑ пўртре çӗнӗ çын
Ağlayıp oturuyor	Ларать nyçнe çӗклемест
Erkenden yiyip  içip	Ирех хырӑм тӑрантса
İşe gitti Tĭhtaman	Кайрӗ хире Тӑхтаман
Başı önünde eğik	Пyçнe чиксе хуйхӑрса
Duruyor Narspi gelin	Ларать арӑмӗ паян
Zorla gelin ettiler	Арӑм пултӑм ирӗксӗр
Anne baba sözüyle	Атте анне хушнипе
Fakat garip kızınız	Анчах хӗрӗр мӗскӗнӗр
İyi değil eşiyle	Ырӑ курмасть каччипе
Acımadan bu kıza	Хӗрхенмесӗр хӗрӗре
Yedi kat yabancıya	Çичӗ ютӑн аллине
Koyup yaban ellere	Çичӗ юта ют çӗре
Attınız zavallıyı	Парса ятӑр мӗскӗне
İşte şimdi kızınız	Халӗ хӗрӗр мӗскӗнӗр
Acı ile yaşıyor	Асап курса пурӑнать
Yaşlı kocası onu	Ӑна ватӑ упӑшки
Köpek gibi dövüyor	Йытӑ вырӑнне хурать
Niçin Setnerden beni	Мӗншӗн мана савнинчен
Ayırıp gönderdiniz	Çanлах ятӑр уйӑрса
Sanki neden gelmeden	Мӗншӗн кунта киличчен
Öldürmedim kendimi	Çимepӗм ши хам nyça
Kötü düşmanla niçin	Мӗншӗн хаяр тӑшманпа
Birlikte olacağım	Ман пӗр çуртра пурӑнас
Katlanarak hayatı	Пӗтес мар ши пу çӑмпа
Nasıl sürdüreceğim	Епле тўссе пурӑнас
Evlendirdiler zorla	Качча пачӗç ирӗксӗр
Olmadı güzelliği	Пулмарӗ çкe ырлӑха
Anne baba aklıyla	Атте анне ӑссӑрри
Öğrendim kötülüğü	Ырлӑха мар хурлӑха
Evlendirdiler zorla	Качча пачӗç ирӗксӗр
Ah mutluluk imkansız	Савӑнӑç çyк ку тӗнчен
Anne baba hatası	Атте анне ӑссӑртан
Sevdiğim kaldı yalnız	Савни юлчӗ пӗр  пӗччен
Evlendirdiler zorla	Качча пачӗç ирӗксӗр
Adım kötüye çıktı	Ятӑм çӗрчӗ Taxçaнax
Anne baba hatası	Атте анне ӑссӑртан
Geride acı kaldı	Пулчӗ асапӑм анчах
Evlendirdiler zorla	Качча пачӗç ирӗксӗр
Hayat acı ve keder	Манӑн пурӑнӑç хӗн  хур
Anne baba hatası	Атте анне ӑссӑртан
Yaşamak neye yarar	Капла пурӑнса мӗн пур
Evlendirdiler zorla	Качча пачӗç ирӗксӗр
Ah mutluluk imkansız	Пулмарӗ çкe ырлӑха
Anne baba hatası	Атте анне ӑссӑрри
Sevdiğim kaldı yalnız	Ырлӑха мар хурлӑха
Fakat bir sevgilim var	Анчах манӑн савни пур
Kurtarır mı o beni	Çӑлaймӗ шим вӑл мана
Onun güçlü elleri	Унӑн вӑйлӑ аллисем
Yok eder mi düşmanı	Пӗтермӗç шим тӑшмана
Yok  böyle öleceksem	Çyк пу çӑма çийиччен
Düşmanı yok edeyim	Тӑшманӗма пӗтерем
Ben acı çekeceksem	Асапланса тўсиччен
Kocamı öldüreyim	Тӑхтамана вӗлерем
Fakat gücüm yeter mi	Анчах вӑйӑм çитӗ ши
Nasıl kurtulacağım	Епле кунтан çӗлӗнас
Tanrım bana yardım et	Эй пўлӗхçӗм пулӑшсам
Şimdi ne yapacağım	Чунӑм çунать мӗн тӑвас
Ya öleyim  ya ölsün	Пӗтсен пӗтем пӗт тӑшман
Çok uzun değil ömür	Пурӑнӑçӑм ырах мар
Arseniğim sen bugün	Наркӑмӑшӑм эс паян
Görevini yapıver	Хӑвӑн ӗçне туса пар
Böyle bu gün evinde	Çaплa паян пўртӗнче
Narspi zavallı yasta	Нарспи мӗскӗн хурланать
Sıkkın canı  dönmede	Чунӗ вӗркет пуçӗнче
Kötü fikirler  başta	Усал шухӑш хускалать
Güneş bir alev gibi	Вут пек хӗвел выляса
Tepeye yükseliyor	Çўл тўпене хӑпарать
Yavaş yavaş salınıp	Хуллен хуллен ярӑнса
Güneye yöneliyor	Кӑнтӑрлана сулӑнать
Dışarda dünya mutlu	Тулта тӗнче хӗпӗртет
Dışarda dünya parlak	Тулта тӗнче ялтӑрать
Narspi evde ağlıyor	Нарспи пўртӗнче йӗрет
Yüreği yarılıyor	Унӑн чӗри çурӑлать
Sentti zıplayıp gelir	Сентти килет сиктерсе
Sopadan atı ile	Кӗвентине утланса
Yengesine atılır	Инкӗш патне çӗмӗрсе
Bağırtı çağırtıyla	Кӗрсе кайрӗ ахӑрса
Vurup kahraman ata	Çanaть паттӑр лашипе
Elindeki çubukla	Хӑй аллинчи хуллипе
Ansızın yengesini	Ӑнсӑртранах инкӗшне
Aldı ayak altına	Tanca илет урипе
Fakat o oynamaya	Анчах вӑл та выляма
Korktu bugün yengeyle	Аптӑрарӗ инкӗшпе
Şaşırarak sokağa	Аптӑраса урама
Çıkıp gitti atıyla	Тухса кайрӗ лашине
Üfürür sarı gelin	Вӗрет сурать сарӑ кин
Çorbayı karıştırıp	Хӑй яшкине пӑтратса
Alevler yılan gibi	Хуран айӗ çӗлен пек
Yükseliyor kıvrılıp	Çynaть вучӗ явӑнса
Yetmiş deniz öteden	Çитмӗл тинӗс леш енчен
Gelir yaşlı Şapatan	Килет карчӑк Шапатан
Üfür  tükür çorbaya	Вӗр сур карчӑк яшкана
Ölsün kötü Tĭhtaman	Пӗттӗр усал Тӑхтаман
Altmış deniz adasında	Утмӑл тинӗс уттинче
Sıçrıyor bakır Pukan	Ларать сикет йӗс пукан
Sıçra da bakır Pukan	Сикех сикех йӗс пукан
Ölsün kötü Tĭhtaman	Пӗттӗр усал Тӑхтаман
Otuz dağın üstünde	Вӑтӑр та пӗр ту çинче
Bakır kazanda piş çorba	Йӗс хуранра пиç яшка
Bu çorbada piş yılan	Çaв яшкара пиç çӗлен
Yan cehennemde koca	Пиç тамӑкра упӑшка
Üfürür sarı gelin	Вӗрет сурать сарӑ кин
Çorbasını kaynatıp	Хӑй яшкине пӑтратса
Kaynar ölüm çorbası	Вилӗм ЯШКИ вӗрет çке
Yılan gibi fışlayıp	Çӗлeн пекех чашласа
Akşam oldu kocası	Каç пулсассӑн упӑшки
Tarladan geri döndü	Килчӗ хиртен çаврӑнса
Masa üstünde tüten	Сӗтел çийӗнче яшки
Güzel çorbayı gördü	Ларать пӑсне кӑларса
Kaşık aldı Tĭhtaman	Кашӑк илчӗ Тӑхтаман
Masa başına çöktü	Ларчӗ сӗтел хушшине
Çorba tatlıym ış bugün	Яшка тутлӑ çке паян
Diye çorbayı övdü	Тесе мухтать яшкине
Gözlerini devirip	Усал куçпа çавӑрса
Yumruğunu çıkardı	Кӑтартать вӑл чӑмӑрне
Çorba güzel ye diye	Яшка тухлӑ çи ларса
Karısını çağırdı	Кашкӑрать валарамне
Yiyeceğim sonradan	Çийп çкe xa кайран та
Şimdi pek aç değilim	Пит çиессӗмех килмест
Diyerek Narspi ordan	Ах Нарспийӗ çавӑнта
Dışarıya çıkıyor	Тухса каять тўсеймест
Dışarda gözyaşını	Тулта ларать куççульне
Toprağa akıtıyor	Тӑпра çине юхтарса
Evdekiyse çorbayı	Пўртри çиет яшкине
Sallanarak içiyor	Урлӑ пирлӗ тайӑлса
İç şimdi iç Tĭhtaman	Çnex çиех Тӑхтаман
Arsenikli çorbayı	Hаркӑмӑшлӑ яшкана
Artık bundan sonra sen	Ӗнтӗ эсӗ малашне
Eş değilsin karına	Упӑшка мар арӑмна
Bittin şimdi Tĭhtaman	Пӗтрӗн ӗнтӗ Тӑхтаман
Bu dünya senin değil	Çyтӑ тӗнче санӑн мар
Narspi çabuk eve gir	Нарспи часрах кӗр пурте
Çok uykum var  yatak ser	Ӑйхӑ килет вырӑн cap
Tarla sürdüm  yoruldum	Ака турӗм  ӗтлентӗм
Sanki içim yanıyor	Ашӑм çунать çaвтepex
Çorbadan sonraki su	Яшка хыççӑн шыв ӗçрӗм
Şarap gibi geliyor	Туйӑнчӗ эрех пекех
Narspi girdi işitip	Нарспи кӗчӗ итлесе
Yere düşmüş kocası	Çӗpтe ларать упӑшки
Tüm içini dışını	Пӗтӗм ӑшне чиккине
Yakmış zehir çorbası	Çyрать хӑватлӑ яшки
Kadın serdi yatağı	Арӑм сарчӗ вырӑнне
Kocasını yatırdı	Упӑшкине вырттарчӗ
Çırpınıp dövünerek	Çӗклe çӗклe çапрӗ те
Ruhunu teslim etti	Чунӗ ўтне хӑварчӗ
Bitti bir can dünyada	Пӗтрӗ пӗр чун тӗнчере
İşleri sona erdi	Ӗçӗсемшӗн хупланчӗ
Bitti Çuvaş ömürü	Пӗтрӗ чӑваш ӗмӗрӗ
Sustu artık yüreği	Унӑн чӗри лӑплӑнчӗ
Evde masa  oturak	Пўртри сӗтел пукансем
Kadını ürkütmede	Хӑратаççӗ арӑмне
Bakarlar acıyarak	Пайтах пӑхрӗç шеллесе
Kocanın ölüsüne	Хуçин сивӗ виллине
Fakat gece olunca	Анчах çӗрле пулчӗ те
Karanlık bastı evi	Сӗм хупларӗ пўрт ӑшне
Adam uzun eliyle	Хӑйӗн вӑрӑм аллипе
Korkutuyor Narspiyi	Хӑратать вӑл Нарспие
Bitti Çuvaş yaşamı	Пӗтрӗ чӑваш ӗмӗрӗ
Yerinden kalkmayacak	Вырӑн çинчен тӑрас çук 
Aç koyun  kuzulara	Выçӑ выльӑх  чӗрлӗхне
Yiyecek atmayacak	Тӑрса апат парас çук
Aç saban atları da	Выçӑ ака лашисем
Kişniyorlar avluda	Кӗçенеççӗ картара
Fakat sizler  yetimler	Анчах эсир тӑлӑхсем
Sahibiniz yok orda	Курассӑр çук хуçapa
Köyün kara ormanı	Ялвӗçӗнче сӗм вӑрман
Hışır hışır hışırdar	Чашӑлтатать çулçипе
Tepede ışıl ışıl	Хушка çӑлтӑр вылятать
Parlak yıldızlar oynar	Çyл Tўnepe çуттипе
Huşĭlkalı Çuvaşlar	Хушӑлкари чӑвашсем
Horul horul uyuyor	Çывӑpaççӗ харлатса
Yalnız ambarda baykuş	Анкартинчи тӑмана
Guklayıp uçuşuyor	Анчах вӗçет ухлатса
Yarım ay salınarak	Уйӑх кукри ярӑнса
Orman ardından çıktı	Тухрӗ вӑрман хыçӗнчен
Yavaş yavaş yürüyüp	Шӑппӑн шӑппӑн çeç утса
Narspi evinden çıktı	Тухрӗ Нарспи пўртӗнчен
Süzüldü gölge gibi	Кайрӗ мӗлке пек шуса
Evlerin arkasına	Анкартисем хыçнелле
Köyden çıktı  yöneldi	Ялтан тухрӗ ыткӑнса
Koşup gitti ormana	Чупрӗ вӑрман ӑшнелле
Ay ışığı altında	Курас тесе ӑнтӑлса
Görmeye çalışıyor	Уйӑх чупрӗ тахçанччен
Ormansa arkasından	Вӑрман анчах шавласа
Gürüldeyip çınlıyor	Юлчӗ Нарспи хыçeнчен
Narspi yürür ormanda	Нарспи пырать вӑрманпа
Amaçsız  hızlı hızlı	Темшӗн ытла ыткӑнса
Orman sessizliğiyle	Шӑппӑн тӑрать сӗм вӑрман
Korkutuyor Narspiyi	Нарспи чунне хӑратса
Koca koca ağaçlar	Армак чармак йывӑçсем
Başlarını sallıyor	Пуçӗсемпе суллаççӗ
Narspi gelip geçerken	Нарспи иртсе пынӑ чух 
Yollarını kesiyor	Сулне пўлсе тӑраççӗ
Ağaçlar arasında	Ват йывӑçсем хушшинче
Şeytanlar oynaşmakta	Арçурисем выляççӗ
Narspi gelip geçerken	Нарспи иртсе пынӑ чух
Ona el uzatmakta	Аллисене тӑсаççӗ
Ansızın rüzgar çıktı	Сасартӑках çил тухса
Azıverdi gür orman	Асрӗ кайрӗ сӗм вӑрман
Çepeçevre haykırır	Йӗри тавра ахӑрать
Tut karını Tĭhtaman	Тыт арӑмна Тӑхтаман
Tut karını ihtiyar	Тыт арӑмна упӑшка
Kaçıyor kötü karın	Тарать усал арӑму
Sanki bir şeytan gibi	Вӑтӑр та пӗр шуйттан пек 
Orman ulur u u u	Вӑрман улать у у у
Erkenden giyinerek	Ирех тӑрса тумланса
Sentti oyuna gitti	Сентти тухрӗ выляма
At sopasına binip	Кӗвентине утланса
Yengeciğine koştu	Чупрӗ инкӗшне курма
Fakat yenge evde yok	Анчах инкӗш курӑнмасть
Amcasıysa uyuyor	Пиччӗш халь те çывӑрать
Ne yapsa uyanmıyor	Тӑратса та вӑранмасть
Sentti çok şaşırıyor	Сентти шӑпах аптӑрать
Biri gelip girdi de	Пӗр Çын килсе кӗчӗ те
Yerinde donup kaldı	Хытса кайрӗ вырӑнтах
Bakıp durdu durdu da	Пӑхса тӑчӗ тӑчӗ те
Oradan çıkıp gitti	Тухса кайрӗ çaвӑнтах
Gittikten biraz sonra	Пӑртак тӑрсан вӑл кайсан
Eve insanlar doldu	Тулчӗ пўрте тулли çын
Nasıl ölmüş Tĭhtaman	Епле вилнӗ Тӑхтаман
Narspi gelin ne oldu	Ӑçтa кайнӑ Нарспи кин
Yok  ne kadar sorsan da	Çyк мӗн чухлӗ ыйтсан та
Ölü cevap veremez	Сире виле калас çук
Narspi kaçmış ormana	Нарспи çўрет вӑрманта
Onu kimse bulamaz	Эсир ӑна тупас çук
Silpide	Силпире
Büyük Silpi köyünde	Аслӑ Силпи ялӗнче
Hayat geçiyor sakin	Хуллен шӑвать пурӑнӑç
Geçip gitti bayramda	Иртсе кайрӗç çимӗкри
Yaşanan büyük neşe	Ырӑлӑхпа савӑнӑç
Çuvaş gömleği ala	Чӑваш кӗпи улача
Tarlalarda masmavi	Хир варринче кӑн кӑвак
Çalışır türkülerle	Ӗçчен чӑваш вӑкӑр пек
Çuvaş bir öküz gibi	Юрла юрла ӗç тӑвать
Gün doğarken kalkıyor	Тӑрать шaурӑмпуçӗпе
Tarlasına gidiyor	Ирех хире вӑл тухать
Azıcık yemek yiyip	Кӑшт кӑшт апат тӑвать те
Tırpanını alıyor	Çyтӑ çава вӑл йӑтать
Ürün duası edip	Учўк хыççӑн чӑвашсем
Çalışırlar tarlada	Айкашрӗçӗ хирсенче
Kuru ot yığınları	Валем купа капансем
Çayırların üstünde	Ларчӗç улӑх варринче
Keskin tırpan fınladı	Çивчӗ çава вашлатрӗç
Biçilmemiş otlarda	Çyлмaн çаран çийӗнче
Olgun çavdar sarardı	Пуçлӑ ыраш саралчӗ
Bozkınn ortasında	Çeçeнxиpceн хушшинче
Dedikodu çok köyde	Сӑмах нумай ял çинче
Dilinse kemiği yok	Çeмçe чӗлхе вӗçӗнче
Doğru olan da vardır	Тӗрӗсси те пур тӑр çав
Bu sözlerin içinde	Ялти сӑмах хушшинче
Silpide de insanlar	Силпире те этемсем
Narspi  Tĭhtaman  diyor	Нарспи Тӑхтаман тeççe
Çoktandır Tĭhtamanın	Вӗсем тaxçaн Тӑхтаман
Yaptığını biliyor	Хаяррине пӗлеççӗ
Miheter korkusuyla	Михетертен шикленсе
Gizlice konuşuyor	Вӑрттӑн çӗрте сӑмахсем
Başlarını eğerek	Пуçне чиксе шеллесе
Çuvaşlar üzülüyor	Аптӑраççӗ чӑвашсем
Setner çocuk  herkesten	Сетнер ача çынсенчен
Bu sözleri duyunca	Çaв сӑмаха илтсенех
Ayrıldı annesinden	Амӑшӗнчен уйрӗлса
Yürüdü tek başına	Кайрӗ таçта пӗчченех
Tarlada çalışanlar	Çынceм хирте ӗçлесе
Akşam eve dönüyor	Каçпа килне килеççӗ
Akşam yemeği yerken	Каçхи апат тунӗ чух
Narspiyle Setner diyor	Нарспи Сетнер тиеççӗ
Setner yürüdü yalnız	Сетнер утрӗ пӗр пӗччен
Girip gitti ormana	Кӗрсе кайрӗ вӑрмана
Narspinin acısıyla	Нарспи асапне илтсе
Ölüm kusar düşmana	Вилӗм сунать тӑшмана
Karanlık bastıracak	Тӗттӗм пулӗ каç пулӗ
Düşmana gidene dek	Тӑшман патне çитиччен
Düşmanım yok olacak	Тӑшман чӗри лӑпланӗ
Güneş doğuncaya dek	Хӗвел кусса тухиччен
Gün çıkıp  ışıtacak	Хӗвел тухӗ çутатӗ
İnsanlar uyanacak	Этем тӑрӗ ӑйхӑран
Düşman uyanmayacak	Тӑшман анчах вӑранмӗ
Uyku ağır olacak	Ӑйхи ытла йывӑртан
Gün çıkıp  ışıtacak	Хӗвел тухӗ çутатӗ
Olacağız ormanda	Эпӗ пулӑп вӑрманта
Ne Narspi evde olacak	Тӑшман выртӑн хускалмӑн
Ne de düşman hayatta	Нарспи пулми çуртӑнта
Fakat Narspi o yokken	Анчах Нарспи унсӑрах
Çıkıp gitti evinden	Кӗçӗр тухрӗ килӗнчен
Kaçıverdi düşmandan	Xӑex тарчӗ ташманран
Sevgilisi gelmeden	Савни пырса çитиччен
Ormanda	Вӑрманта
Gürlüyor kara orman	Шавлать кашлать сӗм вӑрман
Ucu yok bucağı yok	Вӗçӗ хӗрри курӑнмасть
Başsız sonsuz bir rüzgar	Кутсӑр пуçсӑр çил тухсан
Sanki duracağı yok	Чарӑнассӑн туйӑнмасть
Gürülder kara orman	Шавлать кашлать сӗм вӑрман
Haykırır sanki yanar	Тамӑкрӗ пек ахӑрать
Ne cinler ne de şeytan	Те арçури те шуйттан
Böyle oyunlar oynar	Çaв териех ашкӑнать
Dalga dalga gelip yel	Тапхӑр  тапхӑр çил килет
Paldır küldür dönüyor	Пӑлтӑр  палтӑр çавӑрса
Gürüldeyerek orman	Тӗттӗм вӑрман ўхӗрет
Dallar yere değiyor	Çӗpe çитех авӑнса
Kara bulut sürekli	Хура пӗлӗт пӗрмаях
Ormanın tepesinde	Шӑвать вӑрман тӑрринче
Şimşekler parıldıyor	Ярать çиçӗм çӗр çурсах
Bulutlar arasında	Хура пӗлӗт хушшинче
Bir yıldırım düşüyor	Аçа çапать шартлатать
Tüm dünya sarsılıyor	Пӗтӗм тӗнче кисренет
Yağmur ırmaklar gibi	Çyмӑр çырма пек юхать
Çağıldayıp akıyor	Лупашкасенче кӗрлет
Kara  kapkara orman	Сӗм сӗм вӑрман сӗм вӑрман
Niçin b lersin	Мӗншӗн хытӑ шавлатӑн
Gürül gürül çağlayıp	Мӗншӗн шӑй шӑй шӑхӑрса
Narspiyi korkutursun	Мӗскӗн чуна хӑрататӑн
Orman daha da kötü	Вӑрман тата хытӑрах
Gürlüyor  bağırıyor	Шавлать йӗрет ахӑрать
Tanrım  acı  bırakma	Турӑ çырлах ан пӑрах
Kıyametler kopuyor	Ахӑрсаман хускалать
Ah  günahlı başımı	Ах çылӑхлӑ пуçӑма
Nereye sokayım ki	Ӑçтa чиксе хурам ши
Ah  günahlı canımı	Ах çылӑхлӑ чунӑма
Nasıl saklayayım ki	Епле тытса чарам ши
Zavallı Setneriyse	Епле Сетнер мӗскӗн çкe
Kaybolmuş bu ormanda	Урнӑ вӑрман ӑшӗнче
Koca koca ağaçlar	Апле çирӗп йывӑçсем
Başının üzerinde	Юрлаççӗ nyç тӑрринче
Daracık patikada	Вӑрман хӗсӗк çулӗпе
Kendini avutuyor	Ӑш çуннине пусарса
Gürültüyü bastıran	Вӑрман шавне хуплас пек
Türkülerle yürüyor	Пырать сетнер юрласа
Kara  kapkara orman	Сӗм сӗм вӑрман сӗм вӑрман
Niçin haykırıyorsun	Мӗншӗн хытӑ шавлатӑн
Niçin gür gür gürleyip	Мӗншӗн шӑй шай шӑхӑрса
Onu korkutuyorsun	Мӗскӗн чуна хӑрататӑн
Ah  şu derdimi dinle	Ах ман хуйхӑм итле ха
Niçin beni yandırdın	Мӗншӗн мана çунтаратӑн
Niçin bana  öksüze	Мӗншӗн мана тӑлӑха
Sevinci unutturdun	Савӑнӑçа мантаратӑн
Doğdum sanki annemden	Çypaлтӑм мӗн аннерен
Acı azap çekmeye	Хӗн хур асап курма çeç
Bu azaptan  acıdan	Çaв асапран хӗнлӗхрен
Genç yaşımda ölmeye	Çaмpӑк пуçӑм пӗтни çeç
Genç başım yok olmazdı	Çaмpӑк пуçӑм пӗтмӗччӗ
Yoksulluğum bitirdi	Мулӑм çукки пӗтерчӗ
О da bir neden oldu	Вӑлта пулин юрӗччӗ
Kötü insan bitirdi	Çын ухмаххи пӗтерчӗ
Kötülükler eklendi	Çын ухмаххи юрӗччӗ
Kötü düşman bulundu	Усал Тӑшман тупӑнчӗ
İnsan kötü değilse	Усал Тӑшман пӗтӗччӗ
Tanrının yazdığıydı	Турӑ çырни курӑнчӗ
Setner şarkı söylüyor	Сетнер юрлать юррине
Esip güçlü fırtına	Вӑйлӑ тӑвӑл тапранса
Bu şarkıyı alıyor	Сетнер юррине илсе
Uçuruyor ormanda	Вӗçет йӗрсе ахӑрса
Bu kaygılı ağlayış	Çaв хуйхӑллӑ сасӑсем
Yüreği parçalıyor	Чуна çypca йӗреççӗ
Rüzgarlarla birlikte	Вӑйлӑ тӑвӑлпа пӗрле
Her yere ulaşıyor	Taçтa çитex çитеççӗ  
Kara orman içinde	Хура вӑрман ӑшӗнче
Yavaş yavaş eriyor	Хуллен  хуллен пӗтеççӗ
Şarkıdaki gözyaşı	Çaв юрӑри куççульсем
Bir cana ulaşıyor	Пӗр чун патне çитеççӗ
Orada uzaklarda	Taçтaн Taçтaн аякран
Biri daha ağlıyor	Тепӗри хирӗç макӑрать
Kötü dertle kaygıyla	Усал асап хуйхӑран
Bir can daha yanıyor	Унта тепӗр чун çунать
Türkü söyleyen bir ses	Такам юррин сассисем
Setnere ulaşıyor	Кӗрет Сетнер хӑлхине
Sert rüzgarla birlikte	Вӑйлӑ тӑвaлпа пӗрле
Setner türkü söylüyor	Юрлать Сетнер юррине
Kara kapkara orman	Хура вӑрман сӗм вӑрман
Niçin böyle gürledin	Мӗншӗн хытӑ шавлатӗн
Sesin sevgilim gibi	Савни пекех юрласа
Yüreğimi ürküttün	Вилнӗ чуна вӑрататӑн
Kara  kapkara orman	Тӗттӗм вӑрман сӗм вӑрман
Aldatma şu öksüzü	Ан ултала тӑлӑха
Sesin sevgilim gibi	Савни пекех юрласа
Salma kötülüğünü	Ан хӑварсам хурлӑха
Büyük de kara orman	Аслӑ вӑрман сӗм вӑрман
Bana doğruyu söyle	Мана чӑнне кала ха
Acıyıp şu canıma	Мӗскӗн чуна шеллесе
Artık yarimi göster	Чун савнине кӑтарт ха
İşte işte geliyor	Анчах утать кунталла
Bana doğru bir kadın	Ман паталла хӗрарӑм
Tanrım sen bana acı	Ырӑ турӑ çырлахсам
Narspi  Narspi sen misin	Нарспи Нарспи эсӗ им
Aşıklar kavuşunca	Икӗ савни пӗрлешсен
Meşe başını eğdi	Пуçне тайрӗ ват юман
Rüzgar bir kez esti de	Пӗр ик тапхӑр çил вӗрсен
Sonra tümüyle sustu	Шӑп лӑпланчӗ сӗм вӑрман
Dağıldı kara bulut	Хура пӗлӗт саланса
Gitti orman ardına	Пӗтрӗ вӑрман хыçӗнчe
Güneş sıcak gülüyor	Хӗвел пӑхать шӑратса
Kuşlar öter yuvada	Кайӑк юрлать йӑвинче
Çim üstünde çiğlere	Курӑк çинчи сывлӑма
Gün sıcağı düşüyor	Хӗвел парать ӑшшине
Sevişen iki cana	Икӗ чуна савӑшма
Gün ışığı düşüyor	Хӗвел парать çуттине
Işıldıyor güzel gün	Ялтӑртатать ырӑ кун
Kötü günün işi ne	Усал кунӑн мӗн ӗç пур
Mutlu yürür iki can	Савӑнса утать икӗ чун
Yabancının işi ne	Çичӗ ютӑн мӗн ӗç пур
Fakat orman içinde	Анчах вӑрман ӑшӗнче
Kara kuş cayırdıyor	Хура кайӑк чӑйлатать
Ay Tĭhtaman Tĭhtaman	Ай Тӑхтаман Тӑхтаман
O Narspiyi istiyor	Нарспи чунне вӑл шырать
Baba Anne	Атте Анне
Setnerlerin evinde	Сетнер пӗчӗк пўртӗнче
Oturmuşlar başbaşa	Вӗсем иккӗш лараççӗ
Alçacık bir masada	Лутра сӗтел хушшинче
Yemek hazırlanmakta	Каçхи апат тӑваççӗ
Setnerin anacığı	Сетнер ватӑ амӑшӗ
Komşudan turĭh buldu	Турӑх тупрӗ кўршӗрен
Hazırlayıp yemeği	Çӑкӑp тӑвap кӑларса
Masa üstüne koydu	Хучӗ сӗтел ӑшӗнчен
Yemek yiyip iki can	Апатланса икӗ чун
Sevgiyle konuşuyor	Хӗрў сӑмах калаçать
Setnerin anacığı	Ватӑ карчӑк амӑшӗ
Dinleyip oturuyor	Шӑппӑн итлесе ларать
Anıyorlar geçmişi	Асӑнаççӗ ӗлӗкхи
İyi güzel geçmişi	Ырӑ лӑпкӑ пурӑнӑçне
Geçmişteki sevinci	Каçхи вӑйӑ уллаха
Ve bayram öncesini	Çимӗкчeнxи кунсене
Ansızın işitildi	Сасартӑках илтӗнчӗ
Ayak sesi dışardan	Ура сасси пӑлтӑртан
Miheterle karısı	Михетерпе карчӑкӗ
Gelip girdi kapıdan	Килчӗç кӗчӗç алӑкран
Yaşlı Kadın	Карчӑк
Bizim Narspi bu evde	Пирӗн Нарспи ку пўртре
Değil mi  diye geldik	Çyк ши тесе килтӗмӗр
Köydeki insanlardan	Ялти ырӑ çынсенчен
Burada diye işittik	Кунта тесе илтрӗмӗр
Miheter	Михетер
Eh kız kız kızım sen	хӗр хӗ ӗрхӗр иэс
Narspi ne yaptın böyle	Нарспи мӗскер хӑтлантӑн
Bütün köyün önünde	Епле çынсен умӗнче
Nasıl davrandın böyle	Çaк намӑса кӑтартрӑн
Ne yetmedi ki sana	Мӗн çитмерӗ ши сана
Ne yetmedi dünyada	Мӗн çитмерӗ тӗнчере
Niçin kızım  ne var ki	Мӗншӗн хӗрӗм мӗн пуртан
Sevdin sen bu Setneri	Юрататӑн Сетнере
Zengin kızı başınla	Пуян хӗрӗ пуçупа
Niçin böyle davrandın	Мӗншӗн çапла хӑтлантӑн
Başıma gelmeyeni	Ӗмӗр курм ан намӑса
Bu yaşımda gösterdin	Ват пуçӑмпа кӑтартрӑн
Yaşlı Kadın	Карчӑк
Ne yetmez ki aptala	Мӗн çитмен ши ухмаха
Eşini öldürmeye	Упӑшкине вӗлерме
Ormanda bu Setnerle	Çaк Сетнерпе вӑрманта
Dolaşıp yürümeye	Лапӑш татса çўреме
Miheter	Михетер
Şükür ki şimdiye dek	Турра шӗкӗр халиччен
Kötü söz işitmedim	Усал сӑмах илтменччӗ
Bugünlere geldim de	Çaк тарана çитиччен
Kiremet ilişmedi	Киремет те тивменччӗ
Benim evim barkıma	Манӑн килӗм  çypтӑмa
İyi melekler baktı	Ырӑ пирӗшти пӑхатчӗ
Bu nedenle köyümde	Ырӑ пирӗшти пӑхнипе
Adım kötü olmadı	Ялта ятӑм кайманччӗ
Pülih  hĭrpan bu dünya	Пулӗх хӑрпан çyт тӗнче
Beni her zaman sevdi	Мана савса тӑратчӗç
Kĭvak huppi ve güneş	Кӑвак хуппи çут хӗвел
Bana iyi davrandı	Мана тупӑш паратчӗç
Bugüne dek geldim de	Çaк тарана çитрӗм те
Şimdi başım eğildi	Ватӑ пуçӑм усӑнчӗ
Senin böyle olmanla	Эсӗ çапла пулнипе
İyi günlerim bitti	Ырӑ кунӑм пӑсӑлчӗ
Yaşlı Kadın	Карчӑк
Mihetere	Михетере
Dövsene şimdi şunu	Вӑрçсам ӗнтӗ хытӑрах
Cezalandır Setneri	Пӑсӑрлантар Сетнерне
Nasırlı elleriyle	Ӗçре хытнӑ аллипе
İstemesin kızını	Ан хапсӑнтӑр çын хӗрне
Miheter	Михетер
Küçücükten büyüttüm	Мӗн кӗçӗнрен ўстертӗм
Kız gönlünü kırmadım	Хӗр кӑмӑлне татмарӑм
Sevgili kızım için	Савнӑ хӗршӗн пуянлӑх
Bu varlığı topladım	Кунӗн çӗрӗн пуçтартӑм
Ne gece ne de gündüz	Кӑнтӑрла та çӗрле те
Rahat uyku görmedim	Канлӗ ыйхӗ курмарӑм
Kızım için uğraşıp	Хӗрӗмшӗнех тӑрӑшса
Gözlerimi yummadım	Куçӗмсене хупмарӑм
Seni kime vereyim	Епле качча парӑп ши
Diye her an düşündüm	Тесе ялан шутларӑм
Bahtın için uğraşıp	Хӗр телейӗн тӑрӑшса
Zengin koca aradım	Пуян каччӑ шырарӑм
Evlendirdim düğünle	Качча патӑм туй турӑм
Bak bugün neler oldu	Паян акӑ мӗн çитрӗ
Benim yaşlı başıma	Манӑн ватӑ пуçӑма
Bak şimdi neler geldi	Паян акӑ мӗн çирӗ
Yaşlı Kadın	Карчӑк
Acımadın annene	Шеллеместӗн аннўне
Tanrı versin cezanı	Ах çӗр çӑтманӑ пуçна
Kimin kızı oldun sen	Камӑн хӗрӗ пултӑн ши
Kim büyüttü ki seni	Кам ўстерчӗ ши сана
Miheter	Михетер
Küçücükten büyüttüm	Мӗн кӗçӗнрен ўстертӗм
Sana bakıp sevindim	Питне пӑхса савӑнма
İşte bugün geldi de	Çaк тарана çитрӗ те
Kızım için tükendim	Хӗрӗм çирӗ пуçӑма
Anne baba arzusu	Аçу аннў ирӗкӗ
Bir işe yaramadı	Пулчӗ çӗрӗ вырӑнне
Setner için döküldü	Пӗр Сетнершӗн тӑктартӑн
İkimizin ak saçı	Аçу аннўн шур çўçне
Kar etmedi zenginlik	Пулӑшмарӗ пуянлӑх
Kar etmedi sözler de	Пулӑшмарӗ сӑмах та
Zengin koca yanında	Пуян каччӑ çумӗнче
Aptal olunmaz böyle	Апла пулмӗ ухмах та
Narspi	Нарспи
Bu küçücük yaşımda	Аттеçӗм çамрӑк чух
Beni niye verdiniz	Мӗншӗн патӑр хӗрӗре
Şimdi yoksul olsa da	Пуянлӑхра анчах мар
Sevdiğiyle kızınız	Ыр курасси çыннинче
Annesi	Амӑшӗ
Ya kötü kız çok fazla	Усал ытлашши
Açma şimdi ağzını	Ан кар ӗнтӗ çӑварнӑ
Benim içimi yaktın	Аннўн ӑшне çунтаратӑн
Tanrı versin cezanı	Турӑран килесшӗ пуçна
Miheter	Михетер
Bu rezilliği yaptın	Çaк намӑса кӑтартрӑн
Köylüler ne diyecek	Ялти çынсем мӗн калӗç
Seni hatırlayarak	Хӗрне ан ман ват супнӑ
Hep beni gösterecek	Аçу çине кӑтартӗç
Fakat köylünün ağzı	Анчах ялти çӑвapceм
Ne kadar konuşsa da	Кирек мӗн те калаçчар
Adın kötüye çıksa	Яту çӗрнӗ пулсан та
Yine benim kızımsın	Çanax эсӗ манӑн хӗр
Haydi kızım dönelim	Атя хӗрӗм таврӑнар
Delik deşik bu evden	Шӑтӑк шатӑк ку пўртрен
Başka koca bulalım	Тепрер каччӑ тупӑпӑр
Daha kötü olmadan	Яту çӗрсех кайиччен
Haydi Narspi ağlama	Атя Нарспи ан хуйхӑр
Senin baban var yine	Санӑн аçу пур вӗт ха
Adın kötü olsa da	Яту п ӗтнӗ пулсан та
Baban zengindir gene	Аçун мулӗ пур вӗт ха
Yaşlı Kadın	Карчӑк
Haydi çabuk ol köpek	Атя йытӑ хӑвӑртрах
Bir kez bakmadın bana	Пӗртте мана пӑхмастӑн
Keçe yüz Setner  köpek	Сетнер йытӑ кӗççе пит
Zengin kızını kapma	Пуян хӗрне ан хапсӑн
Narspi	Нарспи
Ey babam babacığım	Аттеçӗм аттеçӗм
Niçin yediniz beni	Мӗншӗн мана çиетӗн
Günahlı kızınızı	Намӑс кўне хӗрӗре
İstiyorsunuz geri	Хӑвӑн патна чӗнетӗн
Yaşlı Kadın	Карчӑк
Bak işte ne söylüyor	Ав тата мӗн калаçать
Bak sevgili kızına	Савнӑ хӗрне итле ха
Miheter	Михетер
Yeter  kadın  konuşma	Çитӗ карчӑк вулашма
Kız konuşuyor dinle	Хӗр сӑмахне итлер ха
Narspi	Нарспи
Kadın olmuş başımla	Арӑм пулнӑ пуçӑмпа
Eve niçin geleyim	Киле пырса тӑрӑпи
Sevmediğim biriyle	Савман качча кайсассӑн
Niye azap çekeyim	Татах асап чӑтӑпи
Yok  yok  baba  çağırma	ÇyK çук атте ан чӗн те
Bundan sonra dönemem	Халь тин киле пыраймӑп
Bunlar olduktan sonra	Çaплa пулса пӗтсен тин
Ben koca bekleyemem	Каччӑ кӗтсе лараймӑп
Siz beni büyüttünüz	Эсир мана ўстертӗр
Çocuk iken sevdiniz	Ача чухне юратрӑр
Fakat büyüdüğümde	Анчах уссе çитрӗм те
Ruhumu bilmediniz	Хӗрӗр чунне курмарӑр
Ben size dua ettim	Эпӗ сире кӗлтурӑм
Ben size çok yalvardım	Эпӗ сире йӑлӑнтaм
Düğün yaklaşınca da	Вӗçне çите пуçласан
Çok ağlayıp sızladım	Йӑваланса макӑртӑм
Fakat siz kızınızı	Анчах эсир хӗрӗре
Bu yaşa getirdiniz	Ўcтepecce ўстертӗр
Sonra da para için	Ўстертӗр те укçашӑн
Öldürüp yok ettiniz	Сутса ярса пӗтертӗр
Çocukken kızınıza	Ача чухне хӗрӗре
Seviyoruz  derdiniz	Юрататпӑр теттӗрччӗ
Kızınız ne istese	Савнӑ хӗрӗр мӗн ыйтнӑ
İşte hazır derdiniz	Ӑна пурте хатӗрччӗ
Büyüyünce babama	Ўссе çитрӗм аттене
Bir yıl bekle  dedim de	Пӗр çул кӗт ха терӗм те
Baba sadece dövdü	Атте вӑрçса пӗтерчӗ
Anne saçımı yoldu	Анне çўçрен сӗтӗрчӗ
Niçin benim gönlümü	Мӗншӗн манӑн кӑмӑла
Bu zavallı gönlümü	Çaв юлашки кӑмӑла
Yapmadın babacığım	Тумарӑн ши аттеçӗм
Şimdi olmazdım böyle	Халь пулмӑттӑм каплалла
Niçin bu kızınızı	Мӗншӗн çапла ху хӗрне
Teslim ettiniz kurda	Парса ятӑн кашкӑра
Senin için güzellik	Саншӑн çав пур ырӑлӑх
Yalnız parada pulda	Мӗнпурӗ те укçара
Acı çektiğim için	Эпӗ асап курнишӗн
Sen suçlusun  ben değil	Ху айӑплӑ эпӗ мар
Setner güvey değilse	Сетнер кӗрў пулмасан
Ben de kızınız değil	Эпӗ сирӗн хӗрӗр мар
Ey babacık  annecik	Эй аттеçӗм аннеçӗм
Setnerle kutsayınız	Сетнерпеле пехиллӗр
Bugünden sonra artık	Çaвӑн чухне тин вара
Birlikte olacağız	Ӗмӗр пӗрле пулӑпӑр
Yaşlı Kadın	Карчӑк
Ay  ay  kızın ne diyor	Ав ав хӗру мӗн калать
Ayartmış şeytan Setner	Сетнер шуйттан илӗртнӗ
Haydi vazgeç Miheter	Михетер каяр ха
Artık yüzüne tükür	Хӗру çине сур ӗнтӗ
Miheter	Михетер
I ıh  Setner  unutma	Ы ых Сетнер астӑвӑн
Sen mahvettin kızımı	Манӑн хӗрӗ эс çирӗн
Artık kötü kız sen de	Эсӗ çавтер усал хӗр
Kuru şimdi bu evde	Хура пўртрех тип эппин
Babanın evine sen	Аçу килне чим  халӗ
Koşarak geleceksin	Хӑвах чупса пырӑн ха
Kıymetini babanın	Аçу мӗнле ыррине
O gün anlayacaksın	Çaвӑн чухне курӑн ха
Haydi  yaşlı kadınım	Атя ватӑ карчӑкӑм
Evimize gidelim	Каяр ӗнтӗ килелле
Kızımıza diyecek	Ӗнтӗ сӑмах пӗтрӗ пулӗ
Sözümüz yoktur bizim	Паян пирӗн хӗрпеле
Yaşlı Kadın	Карчӑк
Mahvol  kuru burada	Пӗтӗр типӗр çакӑнта
Kupkuru dallar gibi	Типӗр хӑрӑк турат пек
Kemiklerin çürüsün	Шӑммӑр шаккӑр çӗриччен
Acı çek köpek gibi	Асапланӑр йытӑ пек
İlenerek gittiler	Тухса кайрӗç ылханса
Sevgili kızlarına	Ашшӗ амӑш хӑй хӗрне
Yol boyu yaşlı kadın	Урам тӑрӑх карчӑкӗ
Söyleniyor kendince	Çanтapaть хӑй сӑмахне
Utanıp kızararak	Намӑсланса хӗрелсе
Kayboldu güneş  battı	Хӗвел анчӗ пытанчӗ
Setnerin annesi de	Сетнер амӑш ахлатса
Sofrayı toparladı	Сӗтел çине пуçтарчӗ
Dört Ölü	Тӑватӑ Виле
Ağır işin ardından	Йывӑр ӗçсем хыçӗнчен
Uyku herşeyden tatlı	Ӑйхӑ темрен те паха
İnsanları Silpinin	Силпи ялин çыннисем
Tatlı uykuya daldı	Кайрӗç тутлӑ ыйӑха
Köydekiler uyuyor	Çывӑpaççӗ этемсем
Kara orman sessizce	Хура вӑрман тӗк тӑрать
Hışıldayıp dururken	Тӑрсан  тӑрсан  чашласа
Rüzgarla uyanıyor	Çил вӗрнипе вӑранать
Çıkıverdi ormandan	Килсе тухрӗç вӑрмантан
İşte iki araba	Акӑ икӗ урапа
Sessizce süzüldüler	Шӑппӑн шурӗç ялалла
Çifter çifter atlarla	Парӑн парӑн лашапа
İşte bir ses yükseldi	Акӑ сасӑ илтӗнет
Yüreği parçalıyor	Чуна çурса ян ярать
Bu sesi işitmiş de	Авӑ cacca илтнӗ те
Bir adam koşturuyor	Пӗр çын урампа чупать
Çıngır çıngır öterek	Шӑлтӑр шалтӑр ташласа
Arabalar koşuyor	Урапасем кустарчӗç
Ormana yönelerek	Вӑрман ӑшне кустарса
Ortadan kayboluyor	Кӗрсе кайрӗç çухалчӗç
İnsanlar haykırıyor	Шӑри шари çын шавлать
Sokakta koşturuyor	Урам тӑрӑх чупкалать
Miheteri soymuşlar	Михетере çаратнӑ
Diyerek  bağırıyor	Тесе пӗри кӑшкӑрать
Herkes yukarı doğru	Пурте тури касалла
Soluk soluğa koşup	Хашка хашка чупаççӗ
Ne olmuş da ne olm uş	Мӗн пулнӑ та мӗн пулнӑ
Birbirinden soruyor	Пӗр пӗринчен ыитaççӗ
Miheteri soymuşlar	Михетере çаратнӑ
Hiç bir şey komamışlar	Пӗр япала хӑварман
Tanrının cezaları	Çӗp çӑтманӑ вӑрӑсем
Tanrıdan korkmamışlar	Турӑран та хӑраман
Miheterle kadını	Михетерпе карчӑкне
Hırsızlar öldürmüşler	Иккӗшне те вӗлернӗ
Yedi hizmetçiyi de	Çичӗ тарçи  тӗрçине
Şarapla uyutmuşlar	Эрех парса ўсӗртнӗ
Setner koşup yetişmiş	Сетнер чупса çитнӗ мӗн
Duyarak seslerini	Илтсе карчӑк сассине
Hırsız  şeytan  baltayla	Вӑрӑ шуйттан пурттипе
Parçalamış başını	Пуçнех çурнӑ унӑнне
Miheteri öldürmüş	Михетере вӗлернӗ
Hiçbir şey bırakmamış	Мулне мӗнне хӑварман
Bu uğursuz hırsızlar	Сӗмсӗр пуçсӑр вӑррисем
Tanrıdan da korkmamış	Турӑран та хӑраман
Zavallı Setner ölmüş	Пӗтнӗ мӗскӗн Сетнер те
Hırsızın baltasıyla	Усал вӑрӑ пурттинччен
Böyle bir şey görmemiş	Унпек усал ӗç курман
Silpi köyü dünyada	Силпи ялӗ халиччен
Miheterin Narspisi	Михетерӗн Нарспийӗ
Bir damla yaş dökmüyor	Пӗр куççуль те юхтармасть
Babasının evinde	Ашшӗн пушӑ килӗнче
Kımıltısız duruyor	Выpӑнтан та хускалмасть
Sanki değirmen taşı	Кӑтӑр кӑтӑр арман чулӗ
Yüreğinin üstünde	Чӗре çинче авӑрать
Ve altında bu taşın	Арман чулӗ айӗнче
Yüreği lime lime	Мӗскӗн чӗре çурӑлать
Ah  yarılıp gitti de	Ах çурӑлса кайрӗ те
Narspi kız yere düştü	Нарспи кайрӗ йӑванса
Aklı başına geldi	Тин ӑн килсе кӗчӗ те
Ağlamaya başladı	Йӗрсе ячӗ кӑшкӑрса
Ey babacık  annecik	Эй аттеçӗм аннеçӗм
Dünyaya niye geldim	Мӗншӗн мана çуратрӑр
Acı çekmek için mi	Тӗнче асапне курма
Gün ışığına çıktım	Кун çутине кӑтартрӑр
Ey tanrım  ey ilahım	Эй турӑçӑм  пулӗхçӗм
Niçin bana can verdin	Мӗншӗн ман а чун патӑн
Zavallı genç başıma	Мӗскӗн çамрӑк пу çӑма
Bir iyi gün vermedin	Пӗр телей те ямарӑн
Yüreciğim  genç başım	Эй чунӑмçӑм çамрӑк пуç
Niçin böyle oldun ki	Мӗншӗн капла пултӑн ши
Bu kocaman dünyanın	Пӗтӗм тӗнче хушшинче
Fazlalığı oldun ki	Эсӗ пултӑн ытлашши
Ağlayıp haykırarak	Йӗре йӗре хуйхӑрса
Yürüdü doğru kıra	Нарспи утрӗ хирелле
Köyden çıktı  yöneldi	Ялтан тухрӗ уттарчӗ
Kendir tarlalarına	Кантӑр варӗ еннелле
Köydekiler acıyla	Ялти çынсем шеллесе
Bakıp kaldı ardından	Пӑхса юлчӗç хыçӗнчен
O gün akşama kadar	Паян пулнӑ ӗç çинчен
Konuştular olaydan	Пакӑлтатрӗç тӗттӗмччен
Öbür gün sabahleyin	Тепӗр кунне ирхине
Tarlaya gitmediler	Чӑваш хире тухмарӗ
Cuma günü diyerek	Эрнекуна асӑнса
Bir iş de yapmadılar	Нимӗн ӗç те тумарӗ
Eskisi gibi sokağa	Ӗлӗкхи пек урама
Sarı kızlar çıkmadı	Сарӑ хӗрсем тухмарӗç
Dans edip eğlenmeye	Вӑйӑ ташшисем ташлама
Cesaretleri yoktu	Каччисем те хӑймарӗç
Yaşlılar öbek öbek	Тӗрлӗ çӗрте ватӑсем
Durup konuşuyorlar	Ушкӑн ушкӑн тӑраççӗ
Miheterin evini	Михетерӗн кил çуртне
Satmayı istiyorlar	Сутма канаш тӑваççӗ
Narspinin arkasından	Нарспи тaçтa кайнӑран
Gittiler aramaya	Ячӗç ӑна шырама
Miheterle kadını	Михетерпе карчӑкне
Gittiler defnetmeye	Пурте утрӗç пытарма
Büyük mezarlıktalar	Аслӑ масар хӑямат
Üç ölü var çukurda	Виçӗ виле шӑтӗӑра
Güzel yiğit Setner de	Чипер ача Сетнер те
Yatmış meşe tabutta	Выртать юман тупӑкра
Herkes güneye doğru	Кӑнтӑрлана пӗтӗм ял
Yürümeye başladı	Пӗççисене шарт çапать
Narspiyi ölü bulup	Нарспи виллине тупса
Öylece kalakaldı	Нимӗн тума аптӑрать
Arayanlar döndüler	Шыракансем таврӑнчӗç
Çatlatarak atları	Лашисене çунтарса
Kendirlikte meşeye	Кaнтӑр  варта йӑмраран
Asmış kendini Narspi	Вилнӗ терӗç çакӑнса
Sonra öldüğü yere	Вара вилнӗ вырӑннех
Onu gömüverdiler	Хучӗç ӑна пытарса
Mezarın çevresine	Тӑпри тавра шӗшкӗрен
Fındıktan çit çektiler	Çaтaн лартрӗç çавӑрса
Gün battı  gece oldu	Хӗвел анчӗ каç пулчӗ
Çuvaş uykuya daldı	Чӑваш çынни çывӑрать
Gün çıktı  aydınlattı	Хӗвел тухрӗ çуталчӗ
Çuvaş işe başladı	Чӑваш ӗçе тытӑнать
Fakat Narspi kız için	Анчах пирӗн Нарспишӗн
Sonsuz gece başladı	Ӗмӗрлӗхе каç пулчӗ
Tabutta sonsuza dek	Ӗмӗр тӗттӗм тупӑкра
Kaygı  keder kalmadı	Хуйхи çуйхи татӑлчӗ
Bir hayat böyle geçti	Çaплa иртрӗ пурӑнӑç
Yok oldu genç insanlar	Пуçӗ пӗтрӗ çамрӑклах
Anne baba isteği	Ашшӗ амӑш ухмахран
Bitti kötü bir sonla	Пӗтрӗ хуйхӑ суйхӑпах
Gördü gün ışığını	Курчӗ çутӑ тӗнчене
Tanrının bağışıyla	Пўлӗх  турӑ пўрнипе
Bir gün oldu sarı kız	Ўсрӗ  пулчӗ capӑ хӗр
Annenin bakmasıyla	Атте анне пӑхнипе
Tanrının isteğiyle	Пўлӗх  туррӑн кӑмӑлӗ
Akıllı bir kız oldu	Аслӑ турӗ хӑй хӗрне
Anne baba arzusu	Атте анне ирӗкӗ
Yedi onun başını	Çиpӗ сарӑ хӗр nyçne
Tabuta yatıverdi	Выртрӗ хӗсӗк тупӑка
Adı kaldı geride	Ячӗ юлчӗ ял çинче
Hüzünlü şarkıları	Ун хурлӑхлӑ юррисем
İnsanların aklında	Юлчӗç çынсен асӗнче
Şimdi bile Silpide	Халь те пулин Силпире
Hatırlanır zavallı	Асӑнаççӗ мӗскӗне
Yağmur yağmasza eğer	Ялан çумӑр çумасан
Sularlar toprağını	Шыв сапаççӗ тӑприне